Фу кайла гум гьатна кӀвала , хтана зу стха Бешир стха хтана акуна .	фу кун @@й @@ла гум гьатун @@на кӀвал @@е , хтун @@на зу стха Бешир стха хтун @@на акун @@на .
Къанивилин , мугьубатдин са гаф гудайвал хьуй .	къан @@ди @@ар @@ди @@н , мугьубат @@ди @@н са гаф гуда @@да @@ай @@вал хьун @@й .
Бакидиз хъфена	баку @@ди @@з хъфе @@на
Им и вири цехера акъвенва .	им и вири цехер @@ди акъвенва @@нва .
ахпа няни хьана , ксана йифиз ана .	ахпа няни хьун @@на , ксун @@на йиф @@ди @@з ана .
« Твах и зи шикил », лугьуда , « а ,» лугьуда « анавай вилаятдин кьилел алай булахдин кьилел эциг » лугьуда .	« Твах и зи шикил », лугьу @@да , « а ,» лугьу @@е « анавай @@й вилаятда @@ди @@н кьил @@е @@л ала @@й булах @@ди @@н кьил @@е @@л эциг » лугьу @@да .
Сарах , сарах зунни Имран тфенгни къачуна фена чун руказ .	сарах , сарах зун @@ни Имран тфенг @@ни къачун @@на фин @@на чун руказ @@ди @@з .
муаллим юлдашари ...	муаллим юлдаш @@ар @@ди ...
фена зун и Бакуда авай зу аялдин патав	фин @@на зун и Баку @@е ава @@й зу аял @@ди @@н патав
"Асеф Мегьманан суварилай къулухъ чун "" Шагьдагъ "" ресторандиз фенай , ацакьна и межлис къейд ийин патакай ."	"асеф Мегьманан @@ди @@н суварилай @@ди @@л @@ай къулухъ чун "" Шагьдагъ "" ресторандиз @@ди @@з фин @@на @@й , ацукьун @@на и межлис къейд ийин @@н патакай ."
Гьар вич акурла хкаждий , къведий , вичал кьве кӀвачел акъваздай кицӀ , лагьана , гила , лагьана , кьил кьехе туна вилер чуьнуьхарзава вичикай , лагьана .	гьар вич акур @@ла хкаж @@ди @@й , къвен @@ди @@й , вич @@ди @@л кьве кӀвач @@е @@л акъвазин @@да @@й кицӀ , лугьун @@на , гила , лугьун @@на , кьил кьехе ту @@на вил @@ер чуьнуьхин @@ар @@зва вич @@ди @@к @@ай , лагьа @@на .
За гьабур маса къачуна , вирини за ваз багъишламишзава .	за гьабур маса къачу @@на , вири @@ни за ва @@з багъишламишатӀани @@зва .
« Фена гъваш абур , тахьайтӀа за ви кьил атӀуз гуда исятда ».	« фе @@на гъваш абур , тахьайтӀа @@тӀа за ви кьил атӀуд @@з гуда @@да исятда @@е ».
АкӀ жезвай хьи , кӀурцӀулди вичал залай жуваз жувазни чин тийиз зун ктӀан хьана идал .	АкӀ жен @@зва @@й хьи , кӀурцӀул @@ди вичал за @@л @@ай жув @@ди @@з жув @@ди @@з @@ни чи @@н тийин @@з зун ктӀан хьун @@на идани @@л .
Лезгиярни Азербайджанда тазвайди тучир .	лезги @@ар @@ни Азербайджан @@е тан @@зва @@й @@ди тучир .
Анай таможня алай Россиядин	анай таможня ала @@й Россия @@ди @@н
И балкӀандини лугьуда хьи , « аку », лугьуда , « ваз а руш акунгаз на лагь хьи », лугьуда , « я руш , заз са къапина цвана яд це .	и балкӀан @@ди @@ни лугьу @@да хьи , « аку », лугьу @@да , « ва @@з а руш акунгаз на лагьа хьи », лугьу @@да , « я руш , за @@з са къапина @@ди @@на цвана @@на яд це .
сонра чашмиш хьана амукъзава чун ки , тфенг гъилеваз чна чуь ягъайтавур ибур ?	сонра чашмиш хьун @@на амукъун @@зва чун ки , тфенг гъилев @@ди @@з чна чуь ягъайтавур ибур ?
икьрар хьайидалай сонра ашукьди лагьана ки , бес , лагьана , ви тӀварчиз са дастан кутуна кӀанда .	икьрар @@ар хьа @@ай @@да @@ла @@й сонра ашукь @@ди лугьун @@на ки , бес , лугьун @@на , ви тӀвар @@ди @@з са дастан кутун @@на кӀан @@да .
ИкӀ хьана куьтягь хьана чан и махни .	ИкӀ хьа @@на куьтягь хьа @@на чан и махни .
« Самур » газет атай береда , « Самур » газетдиз лугьуз жедай ки , къула цай амачир .	« Самур » газет атун @@й бере @@е , « Самур » газет @@ди @@з лугьун @@з же @@да @@й ки , къула цай ама @@чир .
« Ша кван », лугьуда , « гила за ваз гьикӀ куьмекдатӀа .	« ша кван », лугьу @@да , « гила за ва @@з гьикӀ куьмек @@да @@тӀа .
Катна атана им са хуьруьз агакьда .	катна атай @@на им са хуьруьз @@з агакь @@да .
ахпа чун са нянихъди и боеприпас гана рахкъурнава и границадиз .	ахпа чун са няни @@хъ @@ди и боеприпас га @@на рахкъур @@нва и граница @@ди @@з .
« Ваъ , чан хва », лагьана , « им » лагьана , « а накьвадикай туш ».	« ваъ , чан хва », лагьа @@на , « им » лагьа @@на , « а накьвадикай @@ди @@к @@ай туш ».
Ваз хъсан чида , лагьана , эцекна .	ва @@з хъсан чи @@е , лагьа @@на , эцек @@на .
ЭкъецӀна ибуруни жемятдиз лугьуда хьи , бес « куьне квез цӀийи пачагь хкягъа , чун хъфизва чи вилаятдиз ».	ЭкъецӀна ибуруни жемятдиз лугьуда хьи , бес « куьне квез цӀийи пачагь хкягъа , чун хъфизва чи вилаятда @@ди @@з ».
Эскервиле историяр пара жезвайди я , маракьлы .	эскервиле история @@ар пара жен @@зва @@й @@ди я , маракьлы .
Къазах миллет тир	къазах миллет тир
Анай ахпа чун плен гьатна , немецариз .	ана @@й ахпа чун плен гьатда @@на , немец @@ар @@ди @@з .
Ну , а чӀавузни жи кьилелни пара атайди я .	ну , а чӀавуз @@ни жи кьил @@ди @@л @@ни пара атун @@й @@ди я .
ЭвецӀда ибур , эвецӀна аквада хьи , яргъалай са руш къвезва иер , иер , иер , мад маса къиямат .	ЭвецӀда @@да ибур , эвецӀна @@на акваз @@да хьи , яргъал @@ди @@ай са руш къве @@зва иер , иер , иер , мад маса къиямат .
Ваз зун кани я~тӀа , зу тӀварча са шеир кутӀур .	Ваз зун кани @@ди я @@тӀа , зу тӀварча са шеир кутӀур .
ваъ , лагьана , хабар авач , лагьана .	ваъ , лагьа @@на , хабар ава @@ч , лагьа @@на .
Имни зи ихтилат .	им @@ни зи ихтилат .
Идани лагьана :	ида @@ни лугьун @@на :
Агатна Седакъет ханум « Самур » газетдиз , вичин цӀайиникай къулаз вегьена ва « Самур » газетдин къула цай туна .	агатун @@на Седакъет ханум « Самур » газет @@ди @@з , вич @@ди @@н цӀайин @@ди @@к @@ай къул @@ди @@з вегьен @@на ва « Самур » газет @@ди @@н къул @@е цай ту @@на .
Адаз аялар ава ,	ада @@з аял @@ар ава ,
Ибурузни и рушан шикил ахкуна ибуруни агь аладарда .	ибур @@ди @@з @@ни и руш @@ди @@н шикил ахкуна @@на ибур @@ди @@ни агь аладарда @@да .
И гафар тамамарна ашукьди .	и гафар тамамарун @@ар @@на ашукь @@ди .
« Акъадра балкӀандал », лагьана , « терсина , ягъ цӀай , ахъая », лагьана « инай агъуз ».	« Акъадра балкӀан @@ди @@л », лагьа @@на , « терсина , ягъ цӀай , ахъая », лагьа @@на « ина @@й агъуз ».
Зун элкъвена фена мадни чуьдиз .	зун элкъвез @@на фе @@на мад @@ни чуь @@ди @@з .
инани ахпа вахт куьтях хьана ,	ина @@ни ахпа вахт куьтях хьа @@на ,
"Гьа Иси дидеди лагьана :"" Чан руш , вун къачихъ экъечӀа , за дидедихъ галаз гафарзава ."""	"гьа Иси диде @@ди лугьун @@на :"" Чан руш , вун къачихъ экъечӀун , за диде @@ди @@хъ галаз гафарун @@зва ."""
ЭкъецӀна ибуруни жемятдиз лугьуда хьи , бес « куьне квез цӀийи пачагь хкягъа , чун хъфизва чи вилаятдиз ».	ЭкъецӀна ибуруни жемятдиз лугьуда хьи , бес « куьне квез цӀийи пачагь хкягъа , чун хъфизва чи вилаятда @@ди @@з ».
Имани ван къведа и везирриз , кьада и пачагь , тухуда има , эцигда , са кӀвале кутада .	има @@ни ван къве @@да и везирар @@ди @@з , кьада @@е и пачагь , туху @@да има , эциг @@да , са кӀвал @@е кутада @@да .
Зун вал инанмиш хьана ки ,	зун вал инанмиш хьун @@на ки ,
Гьадазни жаза гуз гана .	гьада @@з @@ни жаза гуда @@з га @@на .
Рушахъ галазни мехъерарна ибуру башламишда ина пачагьвализ .	рушахъ галаз @@ни мехъерарна ибуру башламишда ина пачагьвализ .
ИкӀ хьана куьтягь хьана чан и махни .	ИкӀ хьа @@на куьтягь хьа @@на чан и махни .
и гьайванарин чуьгъвена эквез .	и гьаван @@ар @@ди @@н чуьгъвена экве @@з .
Садра захъ галаз са ихьтин са кар хьана .	садра за @@хъ галаз са ихьтин са кар хьун @@на .
А , сонра .	а , сонра .
Чун гафариз~аламукьнава .	чун гафариз.аламукьнава .
ЦӀуьгъвенай зун фена гила , Имран мад вине патай эвицӀна къабагъы ийиз , и вакар къабагъы атун патал ...	ЦӀуьгъвенай зун фе @@на гила , Имран мад винелай патай эвицӀ.хъийа @@на къабагъы ийи @@з , и вак @@ар къабагъы атун пат @@ди @@л ...
Атана дежурнидини эверна по части Анадырдиз .	атун @@на дежурни @@ди @@ни эверин @@на по части Анадырдай @@ди @@з .
хкверла чун рехъ къуна	хкве @@ар @@ла чун рехъ къунва @@на
И Гьаджи Зейналабдин Тагиеваз кӀарасар кӀан хьанва .	и Гьаджи Зейналабдин Тагиев @@ди @@з кӀарасар @@ар кӀан хьа @@нва .
Ийида мехъерар ибуру , яхцӀур югъ , яхцӀур йиф .	ийи @@да мехъерар @@ар ибур @@ди , яхцӀур югъ , яхцӀур йиф .
« Фена », лагьана , « куьне », лагьана , « зи балкӀандин кӀвач галукь тавунвай са чкадлай » лагьана , « заз са тике », лагьана « накьв гъваш » лагьана .	« фе @@на », лагьа @@на , « куьне », лагьа @@на , « зи балкӀан @@ди @@н кӀвач галукь тавунвай @@нва @@й са чка @@ди @@л @@ай » лагьа @@на , « за @@з са тике », лагьа @@на « накьв гъваш » лагьа @@на .
эхтилатарна и Иси диде хъфена .	эхтилатарун @@на и Иси диде хъфин @@на .
Лув гана гьар элкведиз дагъларилай элкъвена зун .	лув гун @@на гьар элкве @@ди @@з дагъ @@л @@ар @@ди @@л @@ай элкъвен @@на зун .
Заз ви кицӀ чидай .	за @@з ви кицӀ чин @@да @@й .
Са югъ , кьве югъ алатда и качалдивай мад эх хъийиз жедач .	са югъ , кьве югъ алатна @@да и качалдивай @@ди @@в @@ай мад эх хъийида @@з жеда @@ч .
Польшадай ахпа тхвана чун Литвадиз ,	Польша @@е @@й ахпа тхва @@на чун Литва @@ди @@з ,
Кьве хванахво рехъ физва , кьве кас рехъ физва .	кьве хванахво рехъ фин @@зва , кьве кас рехъ фин @@зва .
За гила вуч лугьуз кӀанзава ?	за гила вуч лугьу @@з кӀан @@зва ?
Им гатна , лагьана , кӀвализ .	им гатин @@на , лугьун @@на , кӀвал @@ди @@з .
Са сев авай ана ...	са сев ава @@й ана ...
( Я къунши Шуьбяддин , зунни вун са шумуд йис я къуншияр я .	( я къунши Шуьбяддин , зун @@ни вун са шумуд йис я къунши @@ар я .
Идан акъадарна ахпа къагъана чун са шегьердиз .	идани @@н акъадарда @@на ахпа къагъана @@на чун са шегьер @@ди @@з .
« Ша кван », лугьуда , « гила за ваз гьикӀ куьмекдатӀа .	« ша кван », лугьу @@да , « гила за ва @@з гьикӀ куьмек @@да @@тӀа .
Лежет лугьудай станциядал Велибег лагьана са лезги итемдиз вичин пиларамаяр , цехер , кӀарасар туькӀуьрдай цехер аваз хьанва .	Лежет лугьу @@да @@й станция @@е @@л Велибег лагьа @@на са лезги итем @@ди @@з вич @@ди @@н пиларамаяр @@ар , цехер , кӀарасар @@ар туькӀуьрайла @@да @@ай цехер ава @@з хьа @@нва .
Дежурныйдиз эверна ки , лагьана за , сад гагьатзава .	дежурный @@ди @@з эверин @@на ки , лугьун @@на за , сад гагьатун @@зва .
« Исятда гъишни за ваз », лугьуда , « захъ ктадмир анжах ».	« исятда @@е гъишни @@ни за ва @@з », лугьу @@да , « за @@хъ ктадмир @@мир анжах ».
Белке куь гъвечи чӀаварай квезни чир жеда хьанватӀа гьакӀа .	белке куь гъвечи чӀав @@ар @@ди @@ай квез @@ни чир же @@да хьа @@нва @@тӀа гьакӀ @@ди .
« Гила мад чара авач » лугьуда , « са ам авуна кӀанда ма , чна са кӀвалах .»	« Гила мад чара ава @@ч » лугьу @@да , « са ам авун @@на кӀан @@да ма , чна са кӀвалах .»
Трамплин хьана , кьве камни вилик физва .	трамплин хьа @@на , кьве камни вилик фе @@зва .
Ахпани аватна чилал .	ахпа @@ни аватун @@на чила @@ди @@л .
Фидамаз ичӀи гъел гваз физ хьанаш палкандивай , галатна .	фида @@да @@нмаз ичӀи гъел гваз фе @@з хьун @@на @@ш палкан @@ди @@в @@ай , галатун @@на .
Вич хтайла , лагьана , кицӀ кьенвай лагьана .	вич хтун @@й @@ла , лугьун @@на , кицӀ рекъин @@нва @@й лугьун @@на .
Идани лугьузва ки , рушан и чӀавуз ашукьди цӀийи кьиляй ида териф гузва ки ,	ида @@ни лугьун @@зва ки , руш @@ди @@н и чӀавуз ашукь @@ди цӀийи кьил @@ай ида териф гун @@зва ки ,
« Ваъ », лугьуда , « зи пӀузаррал хер хьанва » лугьуда , « а ковшда аваз са яд це кван заз ».	« Ваъ », лугьу @@да , « зи пӀузарар @@ар @@е @@л хер хьа @@нва » лугьу @@да , « а ковш @@е ава @@з са яд це кван за @@з ».
« Адан балкӀандин кӀвач галукь тавур чкадай за гъана кӀанзава хьир накьв », лагьана .	« ада @@н балкӀан @@ди @@н кӀвач галукь тавунвай @@ай чка @@ай за гъана @@на кӀан @@зва хьир накьв », лагьа @@на .
Яшамишда ибур са гьазим чӀувал .	яшамиш @@да ибур са гьазим чӀувал .
Вичин кьилел атай гьадисени ахъайда .	вичи @@н кьил @@е @@л атай @@й гьадисе @@ни ахъа @@й @@да .
Фида и руш алукӀна гададин пекерни , кӀватӀ жеда мейдандал жемят , ахъайда и къуш .	фе @@да и руш алукӀна @@на гада @@ди @@н пекер @@ни , кӀватӀ же @@е мейдандал @@е @@л жемят , ахъа @@й @@да и къуш .
И~арада кьада имни тухуда и кӀвализ .	И.арада @@е кьада @@да имни туху @@да и кӀвал @@ди @@з .
Зун фена , Насруллагь муаллим фена , эхир , акъудна чна има .	зун фин @@на , Насруллагь муаллим фин @@на , эхир , акъудин @@на чна има .
ГьакӀ хьайила , ашукьди , Безханум къвезва къерардиз .	ГьакӀ хьа @@ай @@ла , ашукь @@ди , Безханум къве @@зва къерар @@ди @@з .
И~арада балкӀанди « са фикирарни ийимир » лагьана , « за ваз куьмекда » лагьана .	И.арада балкӀан @@ди « са фикир @@ар @@ни ийи @@мир » лагьа @@на , « за ва @@з куьмек @@да » лагьа @@на .
ха ха ха	ха ха ха
Гададини фикирда , « яраб » лугьуда « зун фейитӀа эвел руш инал туна хьуй бубади атана руш чуьнуьх хъийида .	гададини фикир @@да , « яраб » лугьу @@да « зун фейитӀа эвел руш инал туна хьуй буба @@ди атай @@на руш чуьнуьх хъийида @@е .
Миграгъ къеледив ибурувай агатиз хьанвач .	Миграгъ къеле @@ди @@в ибур @@ди @@в @@ай агатун @@з хьа @@нва @@ч .
Чун чи регьметлу муаллим юлдаш Зейнеддинан руш тухузвай мехъерихъ галай тир .	чун чи регьметлу муаллим юлдаш Зейнеддин @@ди @@н руш тухун @@зва @@й мехъерар @@ди @@хъ галай тир .
са эрменидин кьилел хер хьанава .	са эрмени @@ди @@н кьил @@е @@л хер хьа @@нва .
Фена гьаниз , зазни эверна , запрос кхьана , зани изагьатар кхьана .	фин @@на гьаниз , за @@з @@ни Эвера @@на , запрос кхьин @@на , за @@ни изагьатар кхьин @@на .
анайни ахпа чун окруженияда гьатна , вири къуна чун гьана .	ана @@й @@ни ахпа чун окружения @@е гьатда @@на , вири къунва @@на чун гьа @@на .
Са арадлай яру хьана гьуьлуьн винел пад , сакит хьана .	са арадлай яру хьа гьуьлун @@ди @@н винел пад , сакит хьа .
О жумледен , чак и чи юлдаш алман дили муаллим Себрилла муаллимни галай .	о жумледен , чак и чи юлдаш алман дили муаллим Себрилла муаллим @@ни галай .
вич , абур атана и кӀвалара гьахнава кьван .	ви @@ч , а @@бур атай @@на и кӀвал @@ар @@е гьах @@нва кьван .
За , мисал уьчуьн , рикӀ массаж адан ,	за , мисал уьчуьн , рикӀ массаж ада @@н ,
Гададизни вуч чара жеда ?	гада @@ди @@з @@ни вуч чара же @@да ?
Чун гьар заставал фейила , зун а кицӀихъ галаз къугъванни ийидай .	чун гьар застава @@л фин @@ай @@ла , зун а кицӀ @@ди @@хъ галаз @@з къугъван @@ни ийин @@да @@й .
Паспортар , мицибур ...	паспорт @@ар , мицибур ...
Зани лугьузва ки , им пепе яни им вуш яни ?	за @@ни лугьун @@зва ки , им пепе я @@ни им вуш я @@ни ?
Галатна хьана ма .	галатун @@на хьун @@на ма .
Писвал ийиз кӀанзава хьир гададиз .	писвал @@вал ийи @@з кӀан @@зва хьир гада @@ди @@з .
Ана мугьарибе хьана .	ана мугьарибе хьа @@на .
Акъахда и гада балкӀандал , фида ибур гьуьлуьн кӀануз .	акъах @@е и гада балкӀан @@л , фе @@да и @@бур гьуьлун @@ди @@н кӀан @@ди @@з .
Фена зун аяларихъ галаз экъвена	фин @@на зун аял @@ар @@ди @@хъ галаз экъвен @@на
Ина са шумуд вахтара мугьарибейра хьана ахпа зал хер хьанва .	ина са шумуд вахт @@ар @@ди мугьарибе хьа @@на ахпа за @@л хер хьа @@нва .
« Бес за вучин », лагьана , « зун гьин патахъ фин », лагьана , « Зун гьиниз фин », лагьана ?	« Бес за вуч @@ди @@н », лагьа @@на , « зун гьин пата @@хъ фе @@н », лагьа @@на , « зун гьиниз фе @@н », лагьа @@на ?
Инални хъфелахъди аладар хьана и эрмени ивиди тухвана , кьилел хер хьанава эхир .	инал @@ни хъфе @@ла @@хъ @@ди аладарда хьа @@на и эрмени иви @@ди тухвана @@на , кьил @@е @@л хер хьа @@нва эхир .
юруьмуш хьана дередин яман чкадикай экечӀзавай чун ...	юруьмуш хьун @@на дере @@ди @@н я чка @@ди @@к @@ай экечӀин @@зва @@й чун ...
Ваз тагудай гевгьерар авайди яни », лугьуда .	ва @@з тагудай @@да @@ай гевгьерар @@ар ава @@ай @@ди яни », лугьу @@да .
Еке са !	еке са !
Ну , маса республикайриз , маса аниз акъудзавайди тир .	ну , маса республика @@ар @@ди @@з , маса аниз @@з акъудун @@зва @@й @@ди тир .
Идакай амайди са кӀарабни , са хам я лагьана .	идани @@к @@ай ама @@ай @@ди са кӀараб @@ни , са хам я лугьун @@на .
Ибуру и яхцӀур амни кьуна къулдурни , ибурни кутада са кӀвале .	ибур @@ди и яхцӀур амни кьуна @@на къулдур @@ни , ибур @@ни кутада @@да са кӀвал @@е .
са эрменидин кьилел хер хьанава .	са эрмени @@ди @@н кьил @@е @@л хер хьа @@нва .
Гьабурни чна дуьздик , гьар вичин чкадал динжарна .	гьабур @@ни чна дуьз @@ди @@к , гьар вич @@ди @@н чка @@е @@л динжвалда @@ар @@на .
Ибурикай сада башламишзава рахаз .	ибурикай сад @@ди башламишда @@зва рахаз @@з .
Ленинграддин сергьеддал , Ленинграддин Новгородда .	ленинграддин @@ди @@н сергьедда @@е @@л , Ленинград @@ди @@н Новгородда @@е .
« Зун идаз фена кӀанзавай тир », лагьана , « ибурун гъиляй », лагьана , « чун гьарад саниз къакъатна », лагьана .	« зун идани @@з фе @@на кӀан @@зва @@й тир », лагьа @@на , « ибур @@ди @@н гъиляй », лагьа @@на , « чун гьарад саниз къакъатна @@на », лагьа @@на .
Вун диване Межнун ятӀа .	вун диване Межнун я @@тӀа .
« Адан балкӀандин кӀвач галукь тавур чкадай за гъана кӀанзава хьир накьв », лагьана .	« ада @@н балкӀан @@ди @@н кӀвач галукь тавунвай @@ай чка @@ай за гъана @@на кӀан @@зва хьир накьв », лагьа @@на .
Мугьубатдин зурзун ятӀа .	мугьубат @@ди @@н зурзун я @@тӀа .
ТӀванлай лагьана .	ТӀванлай лугьун @@на .
« Зун идаз фена кӀанзавай тир », лагьана , « ибурун гъиляй », лагьана , « чун гьарад саниз къакъатна », лагьана .	« зун идани @@з фе @@на кӀан @@зва @@й тир », лагьа @@на , « ибур @@ди @@н гъиляй », лагьа @@на , « чун гьарад саниз къакъатна @@на », лагьа @@на .
Анай ахпа чун плен гьатна , немецариз .	ана @@й ахпа чун плен гьатда @@на , немец @@ар @@ди @@з .
Ина йиф хьана чи .	ина йиф хьа @@на чи .
Им зу са сеферни хиялдай акъатзавач .	им зу са сефер @@ни хиял @@е @@й акъат @@зва @@ч .
« Гьим заз хуш хьайитӀа , гьадаз зун фида .»	« Гьим за @@з хуш хьайи @@тӀа , гьада @@з зун фе @@да .»
Са югъ , кьве югъ алатда и качалдивай мад эх хъийиз жедач .	са югъ , кьве югъ алатна @@да и качалдивай @@ди @@в @@ай мад эх хъийида @@з жеда @@ч .
Ну , мад халкьарни ава ина ыы — Са пуд стхадивай , гьелбетда хьи , къеле хуьз жедайди туш .	ну , мад халкьдизни @@ар @@ни ава ина ыы — Са пуд стха @@ди @@в @@ай , гьелбетда @@е хьи , къеле хуьн @@з же @@да @@й @@ди туш .
Кани яр , ваз ви рикӀе лугьудай гафар амани ?	кани @@ди яр , Ваз ви рикӀ @@е лугьу @@да @@й гаф @@ар ама @@ни ?
Гададини « хьуй ма », лугьуда .	гада @@ди @@н @@ди « хьуй ма », лугьу @@е .
Джафер тир кастин тӀвар .	джафер тир кас @@ди @@н тӀвар .
Эхирни ибуру фикир гзаф авуна , гьикӀ къачуда , вуч къачуда .	эхир @@ни ибур @@ди фикир гзаф авун @@на , гьикӀ къачун @@да , вуч къачун @@да .
КицӀ зид я ма .	кицӏ зид я ма .
« Бес чун гьабурун патав хъфена кӀанда , Ша кӀватӀ хьана хъфин чун .»	« Бес чун гьабур @@ди @@н патав хъфена @@на кӀан @@да , ша кӀватӀ хьа @@на хъфин чун .»
И Джагьан пачагьдизни авай тир са паб , садни пуд хва .	и Джагьан пачагь @@ди @@з @@ни ава @@ай тир са паб , сад @@ни пуд хва .
Абуриз палкан хьана .	абур @@ди @@з палкан хьа @@на .
"Заз "" Мама , мама ."""	"за @@з "" Мама , мама ."""
"Мадни за "" Мама !"""	"мад @@ни за "" Мама !"""
И гаф ван хьи кумазни , Гьаджи Зейналабдин Тагиев акъатна хъфизва . 07 : 04	и гаф ван хьи кумазни @@ни , Гьаджи Зейналабдин Тагиев акъат @@на хъфида @@зва . 07 : 04
« АтӀутӀ ибурун кьилер » лагьана .	« АтӀутӀ ибурун кьил @@ер » лагьа @@на .
КӀватӀна инсанар эверда вири .	КӀватӀ @@на инсан @@ар Эвера @@да вири .
ГьакӀ хьана , лагьана , вичи папаз лагьана хьи , лагьана , метӀегъ жен паталай фу гумир адаз .	ГьакӀ хьа @@на , лугьун @@на , вич @@ди папа @@ди @@з лугьун @@на хьи , лугьун @@на , метӀегъ жен патал @@ай фу гумир ада @@з .
Гьадалай сонра ам зун ивиз , киник сандрани эвецӀнаша .	гьа @@ди @@л @@ай сонра ам зун ивиз , киник садра @@ни эвецӀна @@на @@ч .
Ийида мехъерар ибуру , яхцӀур югъ , яхцӀур йиф .	ийи @@да мехъерар @@ар ибур @@ди , яхцӀур югъ , яхцӀур йиф .
Къеледиз гьахьтай рекьер чирна вири .	къеле @@ди @@з гьахьун @@ай рекь @@ар чирин @@на вири .
амаш !	ама @@ш !
Фида руказ .	фин @@да руказ @@ди @@з .
За лагьана за , чун ина амукъда , къвазара машин	за лагьа @@на за , чун ина амукъда @@да , къвазара машин
Фида и гадади и гевгьерар гъана гуда пачагьдиз , пачагьни тамашна пара иер гевгьерар къахчуна рахкуда и гада .	фе @@е и гада @@ди и гевгьерар @@ар гъана @@на гуда @@да пачагь @@ди @@з , пачагь @@ни тамаша @@на пара иер гевгьерар @@ар къахчуна @@на рахкуда @@да и гада .
03 : 4Ӏ	03 : 4Ӏ
гьадан патав фена суьгьбетарна , затӀна	гьа @@ди @@н патав фе @@на суьгьбетар @@на , затӀ @@на
Анай высоковольтный линия физавай	ана @@й высоковольтный линия физава @@зва @@й
Ибуру и яхцӀур амни кьуна къулдурни , ибурни кутада са кӀвале .	ибур @@ди и яхцӀур амни кьуна @@на къулдур @@ни , ибур @@ни кутада @@да са кӀвал @@е .
И пуд стхади лагьана хьи , чна хуьда и къеле .	и пуд стха @@ди лугьун @@на хьи , чна хуьн @@да и къеле .
Заз ибур халкьдизни йаймишна .	за @@з и @@бур халкьдизни @@ди @@з @@ни йаймишин @@на .
Фена и гада , фена са къерехдилай са капашда авай накьв гъана , акъахна балкӀандал хтана , « ма чан буба » лагьана , « за ваз накьв гъана ».	фе @@на и гада , фе @@на са къерех @@ди @@л @@ай са капаш @@е ава @@ай накьв гъана @@на , акъах @@на балкӀан @@л хта @@на , « ма чан буба » лагьа @@на , « за ва @@з накьв гъана @@на ».
только гьаниз тамашава , яни ?	только гьан @@ди @@з тамашун , я @@ни ?
Кьведаз сад .	кьвед @@ди @@з сад .
« Эгер », лугьуда , « са арадлай гьуьлуьн винел пад яру хьайитӀа , ваз чир хьухь хьи », лугьуда , « за гьуьлун шив кьенва , зун гъалиб атанва .	« Эгер », лугьу @@да , « са арадлай гьуьлун @@ди @@н винел пад яру хьайитӀа , ва @@з чир хьухь хьи », лугьу @@да , « за гьуьлун @@ди @@н шив кьена @@нва , зун гъалиб атай @@нва .
Къарлай са йикъуз фена зун , и инсандихъ галаз , и ашукь Нуьсретахъ галаз .	къар @@л @@ай са йикъуз фин @@на зун , и инсан @@ди @@хъ галаз , и ашукь Нуьсрет @@ди @@хъ галаз .
Чох~сагъол абуриз .	Чох.сагъол абур @@ди @@з .
Масадаз , лагьана , гаф гуникай , гьаларикай жемир , жи мугьубат сад я ман .	маса @@е @@з , лугьун @@на , гаф гуни @@к @@ай , гьал @@ар @@ди @@к @@ай жемир @@мир , жи мугьубат сад я ман .
Ну , за гьакӀ стхаяр хвена ма , за жува вахвални авуна , дидевални авуна ма .	ну , за гьакӀ стха @@ар хвена @@на ма , за жув @@ди вах @@ар @@ни авун @@на , диде @@ар @@ни авун @@на ма .
БалкӀан Шагьдагъдин кӀана акъвазарна , кӀарасар къужахтаваз акъудзава Шагьдагъдин винел ва гьанал цай ийизва . 01 : 32	балкӀан Шагьдагъ @@ди @@н кӀан @@е акъвазун @@на , кӀарас @@ар къужахтав @@ди @@з акъуд @@зва Шагьдагъ @@ди @@н винел ва гьан @@ди @@л цай ийи @@зва . 01 : 32
Кани ярдиз ви рикӀе лугьудай гафар амани ?	кан @@ди яр @@ди @@з ви рикӀ @@е лугьу @@да @@й гаф @@ар ама @@ни ?
Хырдаланда йашамишзава , ана къвалахзава ада .	Хырдалан @@е йашамишун @@зва , ана къвалахун @@зва ада .
Чи бубадизни чизвайди тир и зу юлдашдин буба .	чи буба @@ди @@з @@ни чи @@зва @@й @@ди тир и зу юлдаш @@ди @@н буба .
« ХьайитӀа », лагьана « ада хъсан , тахьайтӀа зун рекьида », лагьана .	« хьайитӀа », лагьа @@на « ада хъсан , тахьана @@ай @@тӀа зун рекьи @@е », лагьа @@на .
« Ваъ , чан хва », лагьана , « им » лагьана , « а накьвадикай туш ».	« ваъ , чан хва », лагьа @@на , « им » лагьа @@на , « а накьвадикай @@ди @@к @@ай туш ».
Къе концерт гана куьтяхна , пакани лагьана , ашукь Нуьсрет , лагьана , бес зу тӀварчиз за шеъ кхьихь , лагьана .	къе концерт гун @@на куьтяхин @@на , пака @@ни лугьун @@на , ашукь Нуьсрет , лугьун @@на , бес зу тӀвар @@ди @@з за шеъ кхьихь , лугьун @@на .
Гьа ?	гьа ?
Абур са хуьряй яма чипни .	абур са хуьр @@ай яма чип @@ни .
Гьанал проверка авуна документар ,	гьан @@ди @@л проверка авун @@на документ @@ар ,
Вични дагъви хьиз кӀурцӀулар пара кӀандай инсан я ма .	вич @@ни дагъви хьи @@з кӀурцӀул @@ар пара кӀан @@да @@й инсан я ма .
Хвеши жеда гададизни .	хвеши же @@да гада @@ди @@з @@ни .
Зани абурин кеф гьич вахтинда , исяатни хан тийиз .	за @@ни абур @@ди @@н кеф гьич вахт @@ди @@н @@е , гила @@ни хан тийин @@з .
Зун он докъккъуздиз , мин докъкъузюз ондокъкъуздиз эскервилиз фена .	зун он докъккъуз @@ди @@з , мин докъкъузюз ондокъкъуздиз @@ди @@з эскервил @@ар @@з фе @@на .
Чун Чукоткада Огонь~Копида ава .	чун Чукотка @@е Огонь.Копида ава .
Чи чӀалалди аватна .	чи чӀал @@ди @@л @@ди аватун @@на .
Франциядай Бельгиядиз , ахпа Голландиядиз .	Франция @@ай Бельгия @@ди @@з , ахпа Голландия @@ди @@з .
Чун къвед гагьатна .	чун къвед гагьатна @@на .
А кицӀиз , лагьана , гатдин имкан авачир .	а кицӀ @@ди @@з , лагьа @@на , гатин @@ди @@н имкан ава @@чир .
Кьве дустиниз са руш кӀан жезва .	кьве дуст @@н @@ди @@з са руш кӀан же @@зва .
Атайла , « я гада », лугьуда , « заз ван атана , лагьана , ви кӀвале гевгьерар ава » лагьана .	атай @@й @@ла , « я гада », лугьу @@да , « за @@з ван атай @@на , лагьа @@на , ви кӀвал @@е гевгьерар @@ар ава » лагьа @@на .
Инални хъфелахъди аладар хьана и эрмени ивиди тухвана , кьилел хер хьанава эхир .	инал @@ни хъфе @@ла @@хъ @@ди аладарда хьа @@на и эрмени иви @@ди тухвана @@на , кьил @@е @@л хер хьа @@нва эхир .
« Эгер », лугьуда , « са арадлай гьуьлуьн винел пад яру хьайитӀа , ваз чир хьухь хьи », лугьуда , « за гьуьлун шив кьенва , зун гъалиб атанва .	« Эгер », лугьу @@да , « са арадлай гьуьлун @@ди @@н винел пад яру хьайитӀа , ва @@з чир хьухь хьи », лугьу @@да , « за гьуьлун @@ди @@н шив кьена @@нва , зун гъалиб атай @@нва .
« Вач ма чан руш », лагьана , « тамаша ма .»	« Вач ма чан руш », лагьа @@на , « тамаша ма .»
Хуьруьз хтана	хуьр @@ди @@з хтун @@на
Элкъуьгъ , лагьана .	элкъен , лугьун @@на .
Гадани гъавурда~акьуна хьи , гьуьлуьн шив кьейи чӀал .	гада @@ни гъавурда.акьуна @@на хьи , гьуьлун @@ди @@н шив кьена @@ай чӀал .
Зерна фена гьейетдал .	зерин фин @@на гьаятдал @@е @@л .
Жамаатди заз пара хъсан гуьрметарна .	жемятар @@ди за @@з пара хъсан гьуьрметин @@ар @@на .
( А жамаатдин хипер сонра элкъуьрнин вуна ?)	( А жемятар @@ди @@н хипер сонра элкъуьр @@ни @@н вун @@ди ?)
Сонрани и зу стхани зу диде , ибур сакӀани ам хьанач , рази жезвачир .	сонра @@ни и зу стха @@ни зу диде , ибур сакӀани @@ни ам хьун @@на @@ч , рази жен @@зва @@чир .
зун чал фидамаз абурал аватна мина ... ибур кьена .	зун ча @@л фе @@да @@нмаз а @@бур @@ди @@л аватна @@на мина ... и @@бур кьена @@на .
Зун ахпа направление хгана маса анариз .	зун ахпа направление хга @@на маса ана @@ар @@з .
Севастопольдиз рекъе туна .	севастополь @@ди @@з рекъ @@е ту @@на .
Сонра , зунни гила-	сонра , зун @@ни гила
Текче са юлдашди , и юлдашди са гьайван къачуна .	тек са юлдаш @@ди , и юлдаш @@ди са гьайван къачу @@на .
Са ам аваз телефон аваз , хуьруьн къене са	са ам ава @@з телефон ава @@з , хуьр @@ди @@н къен @@е са
Къамни гьижран жугваз хьана	къамни @@ни гьижран жугван @@з хьун @@на
Ашкъидин рекъе , бес , лагьана , за ваз ихьтин крар , мани туькӀуьрайла , мадни гаф ганач ашукьдиз .	ашкъи @@ди @@н рекъ @@е , бес , лугьун @@на , за ва @@з ихьтин крар , мани туькӀуьрун @@ай @@ла , мад @@ни гаф гун @@на @@ч ашукь @@ди @@з .
За вун тухвана гьадаз гана кӀанзава .	за вун тухвана @@на гьада @@з гана кӀан @@зва .
Зани илисна адал , звоникдал , дежурныйдиз эверна .	за @@ни илисин @@на ада @@л , звоник @@е @@л , дежурный @@ди @@з эверин @@на .
Эхир , вуш ийида , вуш ийидаш , эвецӀна , пекер ала чал	эхир , вуш ийи @@да , вуш ийи @@да @@ш , эвецӀна @@на , пекер @@ер ала чал
« Акъадра балкӀандал », лагьана , « терсина , ягъ цӀай , ахъая », лагьана « инай агъуз ».	« Акъадра балкӀан @@ди @@л », лагьа @@на , « терсина , ягъ цӀай , ахъая », лагьа @@на « ина @@й агъуз ».
зунни гьи ча къвазна	зун @@ни гьи ча къвазна @@на
Чи имини бубади лагьана ки , бес , лагьана , чна , лагьана , ам гьа Шемседдинан гада ятӀа , чна АФия гуда гьадаз .	чи ими @@ни буба @@ди лугьун @@на ки , бес , лугьун @@на , чна , лагьа @@на , ам гьа Шемседдин @@ди @@н гада я @@тӀа , чна АФия гун @@да гьа @@ди @@з .
ЧӀехи гадади лагьана , « чан буба », лагьана , « за изатна фена », лагьана , « гъида », лагьана .	ЧӀехи гада @@ди лагьа @@на , « чан буба », лагьа @@на , « за изатна @@на фе @@на », лагьа @@на , « гъида @@да », лагьа @@на .
Рак гатана фад ахъайна тамашайтӀа , са кьуьзуь къари баде ава .	рак гата @@на фад ахъай @@на тамаша @@й @@тӀа , са кьуьзуь къари баде ава .
"За гила вушда ?"""	"за гила вушун @@да ?"""
Гададизни вуч чара жеда ?	гада @@ди @@з @@ни вуч чара же @@да ?
Жи дагьи гьам я , хьанвай дагьи ма чаз , не , а шикилда авай .	чи дагьи гьам я , хьун @@нва @@й дагьи ма чи @@з , не , а шикил @@е ава @@й .
зунни фу тӀуьна , чна пуда , зунни чал фена .	зун @@ни фу тӀуьна @@на , чна пуд @@ди , зун @@ни ча @@л фе @@на .
Гьар са касдиз чидай кар туш .	гьар са кас @@ди @@з чида @@ай кар туш .
Фена жагъурда за чубан .	фин @@на жагъурун @@да за чубан .
Юлдашарикай къерехда амайди авай , Рагьуллагь муаллим авай .	юлдаш @@ар @@ди @@к @@ай къерех @@е ама @@й @@ди ава @@й , Рагьуллагь муаллим ава @@й .
Зунни , къвазнава гила мама за гуьзлемишзава .	зун @@ни , къвазна @@нва гила мама за гуьзлемишин @@зва .
КицӀ амай туш .	кицӏ ама @@ай туш .
Вуч ийин ?	вуч ийи @@н ?
И пачагьдин тӀварни Джагьан пачагь тир .	и пачагь @@ди @@н тӀвар @@ни Джагьан пачагь тир .
БалкӀанди лугьуда : « вуч хьанва », лугьуда , « мадни кьил кудна хьи », лугьуда , « вуч хьанва , вуч фикирарзава ?»	балкӀан @@ди лугьу @@да : « вуч хьа @@нва », лугьу @@да , « мад @@ни кьил кудна @@на хьи », лугьу @@да , « вуч хьа @@нва , вуч фикир @@ар @@зва ?»
Бес лагьана , ун , Себри гьутӀанал алай , вутӀ хьана ?	бес лугьун @@на , ун , Себри гьутӏана @@л ала @@й , вутӀ хьун @@на ?
И Джагьан пачагьдизни авай тир са паб , садни пуд хва .	и Джагьан пачагь @@ди @@з @@ни ава @@ай тир са паб , сад @@ни пуд хва .
Гьана учебкада хьана зун ругуд вацра .	гьана учебкада @@е хьун @@на зун ругуд вацра @@ди .
ТапарарзаватӀа вичивай вуч лугьуз жеда кьван ?	тапарар @@зва @@тӀа вич @@ди @@в @@ай вуч лугьу @@з же @@да кьван ?
Мадни а балаяр эвлендирмишна ,	мад @@ни а бала @@ар эвлендирмишин @@на ,
Абуру ви кьил тӀарарда », лугьуда .	абур @@ди ви кьил ТӀарамарна @@ар @@да », лугьу @@да .
Гъел ярх~хьай чӀавуз и мелимди лагьана : « Бебир халу , игила вушда ?»	гъел ярх.хьай @@ай чӀавуз и мелимди лагьа @@на : « Бебир халу , Игила вуш @@да ?»
Идазни це жаза » лагьана .	идани @@з @@ни це жаза » лагьа @@на .
Ибуруни им тада анал и вичин тахтунал ацукьарда .	ибуруни им тада анал и вичин тахтунал ацукьарда .
Им къачурла и балкӀанди « вуна нагьахъ къачуна » лугьуда « а гевгьерар .	Им къачурла @@ла и балкӀан @@ди « вун @@ди нагьахъ къачу @@на » лугьу @@да « а гевгьерар @@ар .
Зунни , служитайди я за Америкадин сергьедда , Аляскадин сергьедда , Чукоткада служитайди я .	зун @@ни , служитайди @@ай @@ди я за Америкадин @@ди @@н сергьедда @@е , Аляскадин @@ди @@н сергьедда @@е , Чукотка @@е служитайди @@ай @@ди я .
И балкӀандини лугьуда хьи , « аку », лугьуда , « ваз а руш акунгаз на лагь хьи », лугьуда , « я руш , заз са къапина цвана яд це .	и балкӀан @@ди @@ни лугьу @@да хьи , « аку », лугьу @@да , « ва @@з а руш акунгаз на лагьа хьи », лугьу @@да , « я руш , за @@з са къапина @@ди @@на цвана @@на яд це .
Яргъал акъатна чун ...	яргъал акъат @@на чун ...
Назир муаллимди , Юсуф муаллимди , Идрис муаллимди , Руслан муаллимди ...	назир муаллим @@ди , Юсуф муаллим @@ди , Идрис муаллим @@ди , Руслан муаллим @@ди ...
Гьа , вах , лагьана , кьведани меслегьетарна руказ фин .	гьа , вах , лугьун @@на , кьве @@ди @@ни меслегьетарна @@на руказ @@ди @@з фин @@н .
Велибеган патав .	Велибег @@ди @@н пата @@в .
СССР .	СССР .
Гьа , сагъ~хьурай .	гьа , сагъ.хьурай .
Зун , лагьана , куьмек ая , зун хутах , лагьана , инара тамир , лагьана .	зун , лагьа @@на , куьмек ая , зун хутах , лагьа @@на , ина @@ди та @@мир , лагьа @@на .
Им оказывается , захъ галаз призывник еврей .	им оказывается , за @@хъ галаз призывник еврей .
Гьуьлуьн шив гьуьлуьн балкӀан .	гьуьлун @@ди @@н шив гьуьлун @@ди @@н балкӀан .
Сонра чизвай ибуриз .	сонра чи @@зва @@й ибур @@ди @@з .
Анай ахпа гваз хтанава чун Советдин уьлкведиз .	ана @@й ахпа гваз хта @@нва чун Совет @@ди @@н элкведиз @@ди @@з .
чна мад гьисабзава , сад , къвед , пуд , кьуд ... са цӀукьуд гьисабзава , Имрана цӀувад .	чна мад гьисабин @@зва , сад , къвед , пуд , кьуд ... са цӀукьуд гьисабин @@зва , Имран @@ди цӀувад .
Рушани лугьуда хьи ,» лугьуда , « эвеца , жува къачу ».	руш @@ди @@ни лугьу @@да хьи ,» лугьу @@да , « эвеца , жув @@ди къачу ».
Авуна мехъерар гада ийида ибуру пачагь , рушни жеда идан паб .	авун @@на мехъерар @@ар гада ийи @@да ибуру пачагь , рушни жеда идан паб .
И гададини гъил вегьена са жуьт къачуда .	и гада @@ди @@н @@ди гъил вегьена @@на са жуьт къачу @@е .
А вири аялари а къендер гадар хъийидай .	а вири аял @@ар @@ди а къенд @@ар вегьена хъийида @@да @@ай .
ша экеча чал , Безханум , лагьана .	ша экеча ча @@л , Безханум , лугьун @@на .
Гьинай кӀантӀани заз жагъурна гъваш ».	гьина @@й кӀантӀани за @@з жагъур @@на гъваш ».
Гьада ваз вутӀ хьанатӀа лугьурай .	гьада ва @@з вутӀ хьун @@на @@тӀа лугьун @@рай .
« Ваз вуч хьанва », лагьана ?	« Ваз вуч хьа @@нва », лагьа @@на ?
Авуна мехъерар гада ийида ибуру пачагь , рушни жеда идан паб .	авун @@на мехъерар @@ар гада ийи @@да ибуру пачагь , рушни жеда идан паб .
зун кӀанзавай гадан эскервиле ава .	зун кӀан @@зва @@й гада @@н эскервил @@е ава .
и межлисда чна иштиракна хъсан ...	и межлис @@е чна иштиракун @@на хъсан ...
Кани яр , ваз ви рикӀе лугьудай гафар амани ?»	кан @@ди яр , ва @@з ви рикӀ @@е лугьу @@да @@й гаф @@ар ама @@ни ?»
Ибуруни чаяр хъвана вири ахвариз фида .	ибур @@ди @@ни чаяр хъва @@на вири ахвара @@ди @@з фе @@да .
Къулухъ хтанва чун летний лагердиз , иддихатиз .	къулухъ хта @@нва чун летний лагер @@ди @@з , иддихатиз @@з .
Рази яни вун гьабурилай ?	рази я @@ни вун гьабур @@ди @@ла @@ай ?
Ибурни чӀалах~жеда идал .	Ибур @@ни чӀалах.жеда @@е идаз @@л .
Ун .	ун .
Эхирни ибуру фикирна хьи , ша чун амалдив чун къеледиз гьахьин , фендигарвилелди са , гьахьин чун и къеледиз .	эхир @@ни ибур @@ди фикирин @@на хьи , ша чун амал @@ди @@в чун къеле @@ди @@з гьахьин @@н , фендигар @@ар @@ди @@л @@ди са , гьахьин @@н чун и къеле @@ди @@з .
Фида им цуьгъвенлай мадни концертар гуз иниз .	фин @@да им цуьгъвенлай @@ла @@ай мад @@ни концерт @@ар гун @@з иниз @@з .
са жив къвана , жив	са жив къвана @@на , жив
« За », лугьуда « хкадарда исятда гьуьлуьз » лугьуда , « гьуьлуьн шиврехъ галаз ккӀида » лугьуда .	« за », лугьу @@да « хкадар @@да исятда @@е гьуьлун @@ди @@з » лугьу @@да , « гьуьлун @@ди @@н шиврехъ @@хъ галаз @@з ккӀида @@да » лугьу @@да .
зун чал фидамаз абурал аватна мина ... ибур кьена .	зун ча @@л фе @@да @@нмаз а @@бур @@ди @@л аватна @@на мина ... и @@бур кьена @@на .
Чун , азербайджанар Азербайджанда тазвайди тучир .	чун , азербайджанар @@ар Азербайджан @@е тан @@зва @@й @@ди тучир .
Заз лугьуз кӀанзава ки , Седакъет ханума и ктаб кхьидай береда , къетнен вичи лагьана , эдалет принцип къуна , лагьана .	за @@з лугьу @@з кӀан @@зва ки , Седакъет ханум @@ди и ктаб кхьид @@да @@ай бере @@да , къетнен вич @@ди лагьа @@на , эдалет принцип къуна , лагьа @@на .
Фена экъведа вич .	фе @@на экъвен @@да вич .
Рекье кьуна кутуна кӀаник , лагьана , гьа сад сивиз , гьа са кьвед , гьа кьуьл , акуна хьи , лагьана , им шехьзава .	рекь @@е кьун @@на кутуна @@на кӀан @@ди @@к , лугьун @@на , гьа сад сив @@ди @@з , гьа са кьвед , гьа кьуьл , акьун @@на хьи , лугьун @@на , и @@м шехьин @@зва .
Ахпа винел чи ам хтана , капитан .	ахпа винел чи ам хта @@на , капитан .
Севастопольда мугьарибе хьана ,	севастополь @@е мугьарибе хьа @@на ,
Бебир халу .	бебир халу .
Жемятдизни хвеши жеда иер жаван пачагь хьана .	жемятдизни хвеши жеда иер жаван пачагь хьа .
Гададини лугьуда « я пачагь , за гьинай гъин », лугьуда , « заз чизвач хьир , за ваз вучин , гьикӀ ийин ?»	гада @@ди @@н @@ди лугьу @@да « я пачагь , за гьин @@ай гъин », лугьу @@да , « за @@з чи @@зва @@ч хьир , за ва @@з вуч @@ди @@н , гьикӀ ийи @@н ?»
Ахпа чи дидедихъ галаз гафарна .	ахпа чи диде @@ди @@хъ галаз гафарун @@на .
элкъвена хтана чун мад	элкъвен @@на хтун @@на чун мад
ГьакӀ хьана стха , лагьана , заз , кицӀ авай тир лагьана са , а кицӀин кьилел ихьтин уюнар атана .	ГьакӀ хьун @@на стха , лугьун @@на , за @@з , кицӀ ава @@ай тир лугьун @@на са , а кицӀ @@ди @@н кьил @@е @@л ихьтин уюн @@ар атай @@на .
Ида мугьубатдикай , ашкъидикай кхьин , лагьана .	ида мугьубат @@ди @@к @@ай , ашкъи @@ди @@к @@ай кхьин , лугьун @@на .
Зани вуч ийин ?	за @@ни вуч ийи @@н ?
сад~лагьана гьава хьана чӀулав	сад.лагьана @@на гьава хьа @@на чӀулав
Ида и шеирар кутӀура ма зу тӀварча .	ида и шеир @@ар кутӀура ма зу тӀварча .
Зи гъилерив за вун гьикӀ гун , икьван иер руш ?»	зи гъил @@ер @@ди @@в за вун гьикӀ гун , икьван иер руш ?»
хер хьайила хтанва больницадиз ,	хер хьа @@ай @@ла хта @@нва больница @@ди @@з ,
За лагьана , я Аллагь , им вуч ятӀа ?	за лугьун @@на , я Аллагь , им вуч я @@тӀа ?
ГьакӀ ида вичин дуствал къалурзава ». 02 : 18	ГьакӀ и @@ди вич @@ди @@н дуствал къалур @@зва ». 02 : 18
Заз мад вуш лугьуз кӀанзава .	за @@з мад вуш лугьу @@з кӀан @@зва .
Чун гьанай гваз хъфена	чун гьан @@ай гваз хъфин @@на
Абурикай са руша лагьана ки , Севда хала хтанава .	Абур @@ди @@к @@ай са руш @@ди лугьун @@на ки , Севда хала хтун @@нва .
« Хьуй », лугьуда руша .	« Хьуй », лугьуда руша .
Вил ахвара фена , йифен са береда , зун къарагъна .	вил ахвар @@е фин @@на , йиф @@ди @@н са бере @@е , зун къарагъ @@на .
Алатайла , ибурни атана~агакьда маса вилаятдиз са .	алатайла @@й @@ла , ибурни атана.агакьда маса вилаятда @@ди @@з са .
Имани чна ина кьатӀизва . 04 : 47	има @@ни чна ина кьатӀизва @@зва . 04 : 47
вун седакъетли хъсан къунши я .	вун седакъетли хъсан къунши я .
За и шофердиз лагьана , захъ галай , къвазара лагьана за , машин	за и шофер @@ди @@з лагьа @@на , за @@хъ галаз @@й , къвазара лагьа @@на за , машин
« А бере », лугьуда , « адакай я кицӀ жеда лугьуда , я вак .	« А бере », лугьу @@да , « ада @@к @@ай я кицӀ же @@е лугьу @@да , я вак .
Гьа къванерин харадал гьар са инсанди лянет гуз , тфу гуз , къван вегьиз физва лугьуда .	гьа къван @@ар @@ди @@н хара @@ди @@л гьар са инсан @@ди лянет гун @@з , тфу гуда @@з , къван вегьен @@з фин @@зва лугьун @@да .
Бес , са дагъустанвидин гуьгъуьна гьатна кицӀ катна зи гьейетдай , амач .	бес , са дагъустанви @@ди @@н гуьгъуьна гьатун @@на кицӀ катин @@на зи гьаятдал @@ай , ама @@ч .
Польшадай ахпа тхвана чун Литвадиз ,	Польша @@е @@й ахпа тхва @@на чун Литва @@ди @@з ,
« Гила мад чара авач » лугьуда , « са ам авуна кӀанда ма , чна са кӀвалах .»	« Гила мад чара ава @@ч » лугьу @@да , « са ам авун @@на кӀан @@да ма , чна са кӀвалах .»
На дидедиз ча са эрзе	на диде @@ди @@з ча са эрзе
Тухуда и руш кьилел кӀвале илисарда .	туху @@е и руш кьилел кӀвале илис @@ар @@да .
Эгьтибарсуз , вефасуз .»	эгьтибарсуз , вефасуз .»
Идани авудна руш алцурарна вичин кӀвализ тухурла и руш катда идан гъиляй .	идани авудна руш алцурарна вичин кӀвал @@ди @@з тухурла и руш катда идан гъиляй .
анайни ахпа чун окруженияда гьатна , вири къуна чун гьана .	ана @@й @@ни ахпа чун окружения @@е гьатда @@на , вири къунва @@на чун гьа @@на .
Ибуруни чаяр хъвана вири ахвариз фида .	ибур @@ди @@ни чаяр хъва @@на вири ахвара @@ди @@з фе @@да .
Техминан са цӀуд муаллим чун акъахна машинара чун фена гьанал .	техминан са цӀуд муаллим чун акъахун @@на машин @@ар @@ди чун фин @@на гьана @@л .
Хкадарда и балкӀанди гьуьлуьз , са арадлай ина хкаж йитар , бурулгъан , хкадар хьана цавариз акъатна лепеяр ягъана , каф акъатна гъуьлуьн винел .	хкадар @@е и балкӀан @@ди гьуьлун @@ди @@з , са арадлай ина хкаж йитар @@ар , бурулгъан , хкадар хьа @@на цавалай @@ар @@ди @@з акъат @@на лепеяр @@ар ягъана @@на , каф акъат @@на гъуьлуьн @@ди @@н винел .
« Фена гъваш абур , тахьайтӀа за ви кьил атӀуз гуда исятда ».	« фе @@на гъваш абур , тахьайтӀа @@тӀа за ви кьил атӀуд @@з гуда @@да исятда @@е ».
Гьамани , Седакъет ханума къетне лагьайвал , сегьви хьана цӀуьцӀуьд лагьай кьил кхьанва .	гьамани @@ни , Седакъет ханум @@ди къетне лагьа @@й @@вал , сегьви хьа @@на цӀуьцӀуьд лагьа @@й кьил кхьана @@нва .
Элквена сонра .	элквена @@на сонра .
Зи гъилерив за вун гьикӀ гун , икьван иер руш ?»	зи гъил @@ер @@ди @@в за вун гьикӀ гун , икьван иер руш ?»
Алатайла , ибурни атана~агакьда маса вилаятдиз са .	алатайла @@й @@ла , ибурни атана.агакьда маса вилаятда @@ди @@з са .
и чӀавуз иналай къаз ибур вилик хъфена ...	и чӀав @@ди @@з ина @@л @@ай къаз и @@бур вилик хъфена @@на ...
Ва гьадаз фей береда , гьана , Яламадини ва Худат стан … Яламадини ва Худат станциядин арада са Лежет лугьудай станция ава . 05 : 59	ва гьада @@з фе @@й бере @@е , гьана , Яламадини @@ди @@ни ва Худат стан … Яламадини @@ди @@ни ва Худат станция @@ди @@н арадай @@е са Лежет лугьу @@да @@ай станция ава . 05 : 59
Ахпа отпуска гана заз .	ахпа отпуска га @@на за @@з .
Пятьдесят семь градус мороз за дуьзмуьшайди я , охрана хьайиди я .	пятьдесят семь градус мороз за дуьзмуьшун @@ай @@ди я , охрана @@ди хьа @@ай @@ди я .
Хвеши жеда гададизни .	хвеши же @@да гада @@ди @@з @@ни .
Гьетта лагьана хьи заз , агъзур манат пул гуда кицӀ вичиз це , вичи кицӀ ганач .	гьетта лугьун @@на хьи за @@з , агъзур манат пул гун @@да кицӀ вич @@ди @@з це , вич @@ди кицӀ гун @@на @@ч .
Сад ава , дастан хьиз физава ам гьизяхъине .	сад ава , дастан хьиз фин @@зва ам гьизяхъине .
Бакида комиссоватна анай Гуржистандиз рахкана	баку @@е комиссоват @@на ана @@й Гуржистан @@ди @@з элкъуьр @@на
Бакидиз хъфена	баку @@ди @@з хъфе @@на
« Гьим заз хуш хьайитӀа , гьадаз зун фида .»	« Гьим за @@з хуш хьайи @@тӀа , гьада @@з зун фе @@да .»
вич , абур атана и кӀвалара гьахнава кьван .	ви @@ч , а @@бур атай @@на и кӀвал @@ар @@е гьах @@нва кьван .
Ибуруни тухуда и шикил эцигда булахдал .	ибур @@ди @@ни туху @@да и шикил эциг @@да булах @@е @@л .
Ина са шумуд вахтара мугьарибейра хьана ахпа зал хер хьанва .	ина са шумуд вахт @@ар @@ди мугьарибе хьа @@на ахпа за @@л хер хьа @@нва .
Зун он докъккъуздиз , мин докъкъузюз ондокъкъуздиз эскервилиз фена .	зун он докъккъуз @@ди @@з , мин докъкъузюз ондокъкъуздиз @@ди @@з эскервил @@ар @@з фе @@на .
Вегьена къуна зун къужахда .	вегьен @@на къун @@на зун къужахда .
Егьена , егьена , сонра акутӀа ки , уже им туш , им са дегьшет хьана , гъел .	егьезава @@на , егьезава @@на , сонра аку @@тӀа ки , уже им туш , им са дегьшет хьа @@на , гъел .
ахпа чун са нянихъди и боеприпас гана рахкъурнава и границадиз .	ахпа чун са няни @@хъ @@ди и боеприпас га @@на рахкъур @@нва и граница @@ди @@з .
« Гьа~бередани зун вуна къачуна тур », лугьуда .	« гьа.береда @@е @@ни зун вун @@ди къачу @@на тур », лугьу @@да .
хер хьайила хтанва больницадиз ,	хер хьа @@ай @@ла хта @@нва больница @@ди @@з ,
Анадырдани атана БТР идан чуьгъвена гьатна .	Анадырдай @@е @@ни атун @@на БТР идани @@н чуьгъвена гьатун @@на .
и луьтквечини кьуна тухуда ибуру кутада кӀвале .	и луьтквечи @@ни кьуна @@на туху @@да ибур @@ди кутада @@да кӀвал @@е .
Ида лагьана , земляк , лагьана , зун , лагьана , инара тамир	идавай лагьа @@на , земляк , лагьа @@на , зун , лагьа @@на , ина @@ди та @@мир
Ида заз лагьана хьи , « вун чӀалах хьухь , некедикай хкатин галаз шапӀаяр за вав кицӀ вахкуда .	ида за @@з лугьун @@на хьи , « вун чӀалах хьухь , некеди @@к @@ай хкатин @@н галаз @@з шапӀа @@ар за ва @@в кицӀ вахгун @@да .
Гьана са ихьтин кьиса ава . 05 : 30	гьана са ихьтин кьиса ава . 05 : 30
Хъфена , са гьефтедлай , гъиле кагъаз , са купча аваз им хкезва .	хъфин @@на , са гьефте @@ди @@ла @@ай , гъил @@е кагъаз , са купча ава @@з им хкезва @@зва .
Ваъ , гьуьлуьн винел иви акъат тавуртӀа , зун амач », лугьуда .	ваъ , гьуьлун @@ди @@н винел иви акъат тавур @@тӀа , зун ама », лугьу @@е .
Квез виридаз хъсан чизва ки , Гьаджи Зейналабдин Тагиева Шоллардай Бакудиз яд чӀугнава .	квез вири @@е @@з хъсан чи @@зва ки , Гьаджи Зейналабдин Тагиев @@ди Шоллардай @@ай Бакудиз @@ди @@з яд чӀугваз @@нва .
Алцурарда .	алцурарда @@да .
Ахпа и гадади лугьуда хьи , « бес гила вири хьанва », лугьуда , « бубадини жаза къачуна , муькуьбуруни жаза къачуна , бес ,» лагьана , « муькуь вилаятда зи дидени ама » лагьана , « пуд стхани ама , кьве стхани ама » лагьана .	ахпа и гада @@ди лугьу @@да хьи , « бес гила вири хьа @@нва », лугьу @@да , « буба @@ди @@ни жаза къачу @@на , муькуьбуруни @@ди @@ни жаза къачу @@на , бес ,» лагьа @@на , « муькуь вилаятда @@е зи диде @@ни ама » лагьа @@на , « пуд стха @@ни ама , кьве стха @@ни ама » лагьа @@на .
Машин лагьана , кюветдиз фида ма , амукъда чун инал	машин лагьа @@на , кюветдиз @@ди @@з фе @@е ма , амукъда @@да чун ина @@л
Mадни и чи , абур , девлетари , маса абури хъсанвилер чаз пара къалурна ...	мад @@ни и чи , абур , девлет @@ар @@ди , маса абур @@ди хъсан @@вил @@ер чи @@з пара къалурун @@на ...
Вуна чирадаз гаф гана , лугьузва , белке зун алдатмишарзава тӀа ?	вуна чирадаз @@ди @@з гаф гун @@на , лугьун @@зва , белке зун алдатмишарзава @@ар @@зва тӀа ?
Вичин папаз лугьуда « паб », лугьуда , « къе за а гадани рекьида , свасни , ама , ада гъанвай рушни » лугьуда .	вич @@ди @@н папа @@з лугьу @@да « паб », лугьу @@да , « къе за а гада @@ни рекьи @@да , свасни , ама , ада гъана @@нва @@й руш @@ни » лугьу @@да .
АкуртӀа гум гьатнава , зунни ам хьай киз хьана , кьей киз хьана ма адаз , кичӀе хьана , ун .	акур @@тӀа гум гьатун @@нва , зун @@ни ам хьа @@й ки @@з хьа , кьей ки @@з хьа @@на ма а @@ди @@з , кичӀе хьун @@на , ун .
ЧӀехи хьана кӀурцӀул , и кӀурцӀулдихъ галаз вич лап мягькем дуст хьана .	ЧӀехи хьун @@на кӀурцӀул , и кӀурцӀул @@ди @@хъ галаз @@з вич лап мягькем дуст хьун @@на .
« негъе шагьвар чина акьаз ,	« негъе шагьвар чин @@ди акьан @@з ,
Кьве кам анихъни хкадарзава .	кьве кам анихъ @@ни хкадар @@зва .
Зи гъиляй са хата акъат тавунмаз вун инлай куьч хьана хъвач .	зи гъил @@ай са сегьви акъатун жемир вун инлай куьч хьун @@на хъва @@ч .
Фена и гада , фена са къерехдилай са капашда авай накьв гъана , акъахна балкӀандал хтана , « ма чан буба » лагьана , « за ваз накьв гъана ».	фе @@на и гада , фе @@на са къерех @@ди @@л @@ай са капаш @@е ава @@ай накьв гъана @@на , акъах @@на балкӀан @@л хта @@на , « ма чан буба » лагьа @@на , « за ва @@з накьв гъана @@на ».
Закай игила ... заз са гафни лагьанач .	за @@к @@ай игила ... за @@з са гаф @@ни лугьун @@на @@ч .
Гьа къавумдини са чубандив ганва .	гьа къавум @@ди @@ни са чубан @@ди @@в гун @@нва .
Атанва им Велибеган патав .	атай @@нва им велибега @@н пата @@в .
Гьа къалай иникъ « Самур » газетдин къула авай цӀай уьлуьхнавач . 00 . 39	гьа къал @@ай иникъ « Самур » газет @@ди @@н къул @@е ава @@й цӀай уьлуьхун @@нва @@ч . 00 . 39
Чка атайла лугьун ки , гьа кьиса « КӀцар , кӀцарвияр » газетдани авазва .	чка атай @@й @@ла лугьу @@н ки , гьа кьиса « КӀцар , кӀцарви @@ар » газет @@е @@ни ава @@зва .
Заз вуч лугьуз кӀанзава ки , рикӀивайни , Седакъет ханума эдалет принцип къунва . 03 : 28	за @@з вуч лугьу @@з кӀан @@зва ки , рикӀ @@ди @@в @@ай @@ни , Седакъет ханум @@ди эдалет принцип къунва . 03 : 28
Негъен шагьвар чина акьаз	негъен шагьвар чин @@ди акьан @@з
И рушни пачагь хьана гила башламишда вичин пачагьвализ .	и руш @@ни пачагь хьа @@на гила башламишда @@е вич @@ди @@н пачагьвалда @@ди @@з .
Но хва саламат яни ?	но хва саламат я @@ни ?
Элчиярни ракъузва за	элчиярни @@ар @@ни ракъурун @@зва за
Гьакъикъетда , акуртӀа сегьнеда ида хъсан кьуьлерна , акъатна вичин манийриз яб~акалнама .	гьакъикъет @@е , акур @@тӀа сегьне @@е ида хъсан кьуьлер @@на , акъатун @@на вич @@ди @@н мани @@й @@ди @@з яб.акал @@нма .
Рушни къачуда .	руш @@ни къачу @@да .
Идаз гьаятдин эламетар пара зайиф хьанвай .	ида @@з гьаят @@ди @@н эламет @@ар пара зайиф хьун @@нва @@й .
Сонра лагьана , бес , лагьана , сегьнеда акъатна Безхануман тарифаради ида .	сонра лугьун @@на , бес , лугьун @@на , сегьне @@е акъатун @@на Безхануман тарифаради @@ди ида .
Са эхтилат ийиз кӀанзава заз квез .	са эхтилат ийи @@з кӀан @@зва за @@з квезни @@з .
Вад кьимет за ваз гузва .	вад кьимет за ва @@з гуз @@зва .
Зунни хтана кӀвализ архаин хьана .	зун @@ни хта @@на кӀвал @@ди @@з архаин хьун @@на .
ЭвецӀда ибур , эвецӀна аквада хьи , яргъалай са руш къвезва иер , иер , иер , мад маса къиямат .	ЭвецӀда @@да ибур , эвецӀна @@на акваз @@да хьи , яргъал @@ди @@ай са руш къве @@зва иер , иер , иер , мад маса къиямат .
Зани ишаре гайдалай сонра , лагьана ки , бес , вуна дидедин са жаваб къачу ма .	за @@ни ишаре гун @@й @@да @@л @@ай сонра , лугьун @@на ки , бес , вуна диде @@ди @@н са жаваб къачун ма .
Къваззава ама .	къвазна @@зва ама .
Зун , ашукьдиз сабур амач	зун , ашукь @@ди @@з сабур ама @@ч
Къе йифиз за абуруз вуч той кьадатӀа аку ».	къе йиф @@ди @@з за абур @@ди @@з вуч той кьадатӀа аку ».
сонра ибур мад алад хьана фена явашдак чи виликай .	сонра ибур мад алад хьун @@на фин @@на явашдак чи вил @@ди @@к @@ай .
Бакида комиссоватна анай Гуржистандиз рахкана	баку @@е комиссоват @@на ана @@й Гуржистан @@ди @@з элкъуьр @@на
« Баш~уьсте », лагьана гадайри .	« Баш.уьсте », лагьа @@на гадайри .
"Са шумудрахъ "" мама "" лагьана за ."	"са шумуд @@ар @@ди @@хъ "" мама "" лугьун @@на за ."
Гьа , Севда халади къизил тупӀаларни къгъанава ...	гьа , Севда хала @@ди къизил тупӀал @@ар @@ни къачун @@нва ...
Эскервиле авайла ,	эскервил @@е ава @@ай @@ла ,
Азербайджан патани гьа саягъда ,	Азербайджан пата @@ни гьа саягъ @@е ,
« Йисан инсанар ».	« Йисан инсан @@ар ».
Палкан яхъ , лагьана , и зу гъелни галаз гъин чна .	палкан яхъ , лугьун @@на , и зу гъел @@ни галаз гъида @@н чна .
« Бес за вучин », лагьана , « зи бубадин вилер сакӀани хъсан жезвач », лагьана .	« Бес за вуч @@ди @@н », лагьа @@на , « зи буба @@ди @@н вил @@ер сакӀани хъсан же @@зва @@ч », лагьа @@на .
Ва и кьилни заз вучиз хуш къвезва ?	ва и кьил @@ни за @@з вуч @@ди @@з хуш къве @@зва ?
Има чиз фена ма ...	има ча @@з фин @@на ма ...
Зун бубади хвена , хуьряй акъудна зун шегьердиз агъана бубади хвена .	зун буба @@ди хвена @@на , хуьре @@ай акъуд @@на зун шегьер @@ди @@з агъин @@на буба @@ди хвена @@на .
Са немецди чаз фуни гана	са немец @@ди чи @@з фу @@ни га @@на
Сад~лагьана хкверла	сад.лагьана @@на хкве @@ар @@ла
Фида и руш алукӀна гададин пекерни , кӀватӀ жеда мейдандал жемят , ахъайда и къуш .	фе @@да и руш алукӀна @@на гада @@ди @@н пекер @@ни , кӀватӀ же @@е мейдандал @@е @@л жемят , ахъа @@й @@да и къуш .
зун кӀвала авай , атана чи ... чи дидедин са ам авай тир , диде хьиз акахьнавай са кьуьзуь са къари , Иси диде .	зун кӀвал @@е ава @@й , атнун @@на чи ... чи диде @@ди @@н са ам ава @@й тир , диде хьиз акахь @@нва @@й са кьуьзуь са къари , Иси диде .
Сонра ибурин чуьгъенал им яргъал фена .	сонра ибур @@ди @@н чуьгъенал им яргъал фин @@на .
Вак гьич са гьунар авани ?	вак гьич са гьунар ава @@ни ?
Зун ахпа направление хгана маса анариз .	зун ахпа направление хга @@на маса ана @@ар @@з .
« Хьуй » лугьуда гададини .	« Хьуй » лугьу @@да гада @@ди @@н @@ди .
Абурни чна чӀехи авуна ,	абур @@ни чна чӀехи авун @@на ,
немецарихъ галаз .	немецар @@хъ галаз @@з .
Вичин папаз лугьуда « паб », лугьуда , « къе за а гадани рекьида , свасни , ама , ада гъанвай рушни » лугьуда .	вич @@ди @@н папа @@з лугьу @@да « паб », лугьу @@да , « къе за а гада @@ни рекьи @@да , свасни , ама , ада гъана @@нва @@й руш @@ни » лугьу @@да .
« Гьиниз физва вун , гьиниз физва ?»	« гьиниз фин @@зва вун , гьиниз фин @@зва ?»
Яшамишда ибур са гьазим чӀувал .	яшамиш @@да ибур са гьазим чӀувал .
Бес и ишаре гьикӀ гуда ?	бес и ишаре гьикӀ гун @@да ?
Вич яргъай акван гваз им гъавурда~акьуна хьи , лагьана , зун къвезва им гатаз .	вич яргъай акван гва @@з и @@м гъавурда.акьуна хьи , лугьун @@на , зун къвен @@зва и @@м гата @@з .
Дидедин гьимаенда чӀехи хьанвади я .	диде @@ди @@н гьимаен @@е чӀехи хьа @@нва @@ди я .
Ну , пешком къаз жезвач има , гагьатна .	ну , пешком къаз же @@зва @@ч има , гагьатун @@на .
Фена-фена им акакьда са гьуьлуьн къерехдив .	фе @@на им акакьда @@е са гьуьлун @@ди @@н къерех @@ди @@в .
Адан вичин вах ава , вичелай гъвечӀи вах .	ада @@н вич @@ди @@н вах ава , вич @@е @@л @@ай гъвечӀи вах .
Акатда захъ хъел .	акатун @@да за @@хъ хъел .
Къазахстанда авай чун , Къазахстанда	къазахстанда @@е ава @@ай чун , къазахстанда @@е
Ина яцаривай хуьз тахьана , анай агъуз камуз гъел .	ина яцар @@ар @@ди @@в @@ай хуьз @@з тахьана @@на , ана @@ай агъуз камуз гъел .
Абуру « эвера а гада » лугьуда , « абур ваз къачу » лугьуда , « абур адаз лайих туш ».	абур @@ди « эвера а гада » лугьу @@да , « абур ва @@з къачу » лугьу @@да , « абур ада @@з лайих туш ».
« За », лугьуда « хкадарда исятда гьуьлуьз » лугьуда , « гьуьлуьн шиврехъ галаз ккӀида » лугьуда .	« за », лугьу @@да « хкадар @@да исятда @@е гьуьлун @@ди @@з » лугьу @@да , « гьуьлун @@ди @@н шиврехъ @@хъ галаз @@з ккӀида @@да » лугьу @@да .
Гьарада вичивай жедайвалди чиз гьахна .	гьарад @@ди вич @@ди @@в @@ай же @@да @@й @@валди ча @@з гьахун @@на .
Ибуруни са гьафтеда ядни ганач кьван , лагьана , фу ни ганач кьван .	ибур @@ди @@ни са гьафте @@е яд @@ни гун @@на @@ч кьван , лугьун @@на , фу ни гун @@на @@ч кьван .
Идаз и момент акуна .	идани @@з и момент акун @@на .
И пачагьдин тӀварни Джагьан пачагь тир .	и пачагь @@ди @@н тӀвар @@ни Джагьан пачагь тир .
ахпадиказ Дербентдин паркинай хтана мадни истрагьетна ,	ахпадиказ Дербентда @@ди @@н парк @@ди @@н @@ай хтун @@на мад @@ни истрагьетин @@на ,
« Эвера », лагьана , « и гада къенин къалай жеда пачагь , зунни адан свас .»	« эвера @@ди », лагьа @@на , « и гада къе @@н @@ди @@н къалай же @@да пачагь , зун @@ни адан свас .»
Ахпа къагъана эхцигкъия чкадал . 06 : 34	ахпа къагъана @@на эхцигкъия чка @@е @@л . 06 : 34
Гила кьве кьилихъ ваъ , лагьана , са кьилихъни эцек жедиш , лагьана .	гила кьве кьил @@ди @@хъ ваъ , лугьун @@на , са кьил @@ди @@хъ @@ни эцек же @@ди @@ш , лугьун @@на .
Им гьаятдилай рази туш , и къван ахъатайдилай им рахазва , луьквензава .	им гьаятдилай @@ди @@л @@ай рази туш , и къван ахъатайдилай @@ай @@ди @@ла @@й им рахун @@зва , луьквензава @@н @@зва .
Зани , икӀ явашдиказ мамадиз эверна .	за @@ни , икӀ явашдиказ мама @@ди @@з эверин @@на .
Алцурарда .	алцурарда @@да .
Ядни гумир , фуни гумир .	яд @@ни гумир , фу @@ни гумир .
Тухуда и руш кьилел кӀвале илисарда .	туху @@е и руш кьилел кӀвале илис @@ар @@да .
Хтуларни ава , са пуд хтулни ава заз .	хтул @@ар @@ни ава , са пуд хтул @@ни ава за @@з .
( стихотворение )	( стихотворение )
Гада хвешивиливай , акьахна балкӀандал , гутунна фургъунни , вегьена кӀарасарни , физва Шагьдагъдин кӀануз .	гада хвеши @@ар @@ди @@в @@ай , акьахун @@на балкӀан @@ди @@л , гутун @@на фургъун @@ни , вегьен @@на кӀарас @@ар @@ни , фин @@зва Шагьдагъ @@ди @@н кӀан @@ди @@з .
« Вач ма чан руш », лагьана , « тамаша ма .»	« Вач ма чан руш », лагьа @@на , « тамаша ма .»
вил ахвара фена , ун , фу кана ма .	вил ахвар @@ди фин @@на , ун , фу кун @@на ма .
И руш эгекьайла гадади лугьуда « я руш », лугьуда , « заз капашда авай яд це тӀун » лугьуда .	и руш эгекьайла @@ай @@ла гада @@ди лугьу @@да « я руш », лугьу @@да , « за @@з капаш @@е ава @@ай яд це тӀун » лугьу @@да .
« ХьайитӀа », лагьана « ада хъсан , тахьайтӀа зун рекьида », лагьана .	« хьайитӀа », лагьа @@на « ада хъсан , тахьана @@ай @@тӀа зун рекьи @@е », лагьа @@на .
Зу метлеб сад я .	зу метлеб сад я .
Паекни гана чаз , пекни гана , гьабури чипин солдат хьиз хвена .	паекни га @@на чаз , пекни га @@на , гьабур @@ди чип @@ди @@н солдат хьиз хвена @@на .
« Гьагь », лугьуда « и руш чи гъиляй акъатна икьван иер руш ».	« Гьагь », лугьу @@е « и руш чи гъиляй акъат @@на икьван иер руш ».
Ширин хьтин яр хьурай заз	ширин хьтин яр хьурай за @@з
Чаз са тӀимил~кьван фу ча , садни чаз телефон гьинал алатӀа лагь	чи @@з са тӀимил.кьван фу ча , сад @@ни чи @@з телефон гьина @@л ала @@тӀа лагьа
« Гьа и луьтквечидини », лагьана , « идани », лагьана « зун », лагьана , « гададивай къакъудна », лагьана , « алцурарна вичин кӀвализ тухузвай тир .	« гьа и луьтквечи @@ди @@ни », лагьа @@на , « идани @@ни », лагьа @@на « зун », лагьа @@на , « гададивай къакъудна @@на », лагьа @@на , « алцурарда @@ар @@на вич @@ди @@н кӀвал @@ди @@з тухуда @@зва @@й тир .
Лагьана чна , рекъел эвицӀ~хъувуна , рехъ чира ман .	лагьа @@на чна , рекъ @@е @@л эвицӀ.хъувуна @@на , рехъ чира ман .
За лагьана ки , са са гьефте , кьве гьефте за гьана фена динжвалда .	за лугьун @@на ки , са са гьефте , кьве гьефте за гьана фе @@на динжвалда @@вал @@да .
ТӀимил хкаж хьийбур чуьгъена аваз кутунва . 04 : 34	ТӀимил хкаж хьийбур @@бур чуьгъена ава @@з кутуна @@нва . 04 : 34
Гьадазни жаза гуз гана .	гьада @@з @@ни жаза гуда @@з га @@на .
Ша фин гьуьлуьн къерехдиз » лугьуда .	ша фе @@н гьуьлун @@ди @@н къерех @@ди @@з » лугьу @@да .
Им къачурла и балкӀанди « вуна нагьахъ къачуна » лугьуда « а гевгьерар .	Им къачурла @@ла и балкӀан @@ди « вун @@ди нагьахъ къачу @@на » лугьу @@да « а гевгьерар @@ар .
зунни гьи ча къвазна	зун @@ни гьи ча къвазна @@на
Катна атана им са хуьруьз агакьда .	катна атай @@на им са хуьруьз @@з агакь @@да .
Ида лагьана , земляк , лагьана , зун , лагьана , инара тамир	идавай лагьа @@на , земляк , лагьа @@на , зун , лагьа @@на , ина @@ди та @@мир
Абурувай пара ибре ибретани шейер къачуз жеда~чавай .	а @@бур @@ди @@в @@ай пара ибре ибретани шей @@ер къачун @@з же @@да @@чав @@ай .
Эвел са чаяр хъван , са ял ягъан , ахпа истирагьатайдалай сонра квекай сад за хкягъда », лугьуда .	эвел са чаяр @@ар хъван , са ял ягъана @@н , ахпа истирагьатайдалай @@ай @@да @@ла @@й сонра квекай @@ай сад за хкягъа @@да », лугьу @@да .
Чпин хуьруьн патав застава гвай тир са , солдатар авай .	чпин хуьр @@ди @@н патав застава гвайтир тир са , солдат @@ар ава @@й .
« Баш~уьсте », лагьана гадайри .	« Баш.уьсте », лагьа @@на гадайри .
... ахпадаказ хтана обед авуна ,	... ахпадаказ хтун @@на обед авун @@на ,
Иван сятдин цӀикьведаз чав и касди чав кассетар Аллагьдиз шуькуьр вахгана .	йиф @@ди @@н сятдин @@ди @@н цӀикьведаз @@ди @@з чи @@в и кас @@ди чи @@в кассет @@ар Аллагь @@ди @@з шуькуьр гун @@на .
Са арадлай яру хьана гьуьлуьн винел пад , сакит хьана .	са арадлай яру хьа гьуьлун @@ди @@н винел пад , сакит хьа .
Гъилин къен кьван авай .	гъил @@ди @@н къен кьван ава @@й .
Идани лагьана , ки , за ваз лагьана , ки , дидедиз са эрзе ча , элчиярни ракъузва за .	ида @@ни лугьун @@на , ки , за ва @@з лугьун @@на , ки , диде @@ди @@з са эрзе ча , элчиярни @@ар @@ни ракъурун @@зва за .
Вичизни язух атана кицӀин .	вич @@ди @@з @@ни язух атун @@на кицӀ @@ди @@н .
Гаф сад хьана , метлеб сад хьана , икьрар сад хьана , чун санал жервал я .	гаф сад хьун @@на , метлеб сад хьун @@на , икьрар @@ар сад хьун @@на , чун санал жервал я .
са еке са пепе .	са еке са пепе .
Ну , эвецӀна чун гьанузди .	ну , эвецӀун @@на чун гьануз @@ди .
ваъ , лагьана , хабар авач , лагьана .	ваъ , лагьа @@на , хабар ава @@ч , лагьа @@на .
Паекни гана чаз , пекни гана , гьабури чипин солдат хьиз хвена .	паекни га @@на чаз , пекни га @@на , гьабур @@ди чип @@ди @@н солдат хьиз хвена @@на .
Вуна дидедиз ча са эрзе , лагьана	вун @@ди диде @@ди @@з ча са эрзе , лугьун @@на
Руша лугьузва ки , эгер вуна , лугьузва ки , къе йифиз фена Шагьдагъдин кӀукӀвал цай авуна хьуй , гьа цай на экуьнелди хвена хьуй , зун ваз къведа , лугьузва . 01 : 20	руш @@ди лугьу @@зва ки , эгер вун @@ди , лугьу @@зва ки , къе йиф @@ди @@з фе @@на Шагьдагъ @@ди @@н кӀукӀв @@ди @@л цай авун @@на хьуй , гьа цай вуна экуьн @@ди @@л @@ди хвена @@на хьуй , зун ва @@з къве @@е , лугьун @@зва . 01 : 20
гьабурни чна гьар са адав агакьарна .	гьабур @@ни чна гьар са ада @@в агакьун @@ар @@на .
« Хьуй », лугьуда руша .	« Хьуй », лугьуда руша .
Ахпа ивиз жи цӀугъвена военный машинар атана	ахпа ивиз жи цӀугъвена военный машин @@ар атай @@на
Фена-фена им акакьда са гьуьлуьн къерехдив .	фе @@на им акакьда @@е са гьуьлун @@ди @@н къерех @@ди @@в .
ЯхцӀур югъ хьайидилай сура вун фида гьамамдиз , фена цӀийи пекер алукӀна аяр хьана хкведа , гьа~береда чна мехъерарда .	ЯхцӀур югъ хьа @@ай @@ди @@ла @@ай сура вун фе @@е гьамамда @@ди @@з , фе @@на цӀийи пекер алукӀна @@на аяр хьа хкве @@да , гьа.береда @@е чна мехъерар @@ар @@да .
Инай виняй анихъ эвицӀ~хъийа лагьана , куьн , лагьана , асвальтдал аватда , лагьана .	ина @@й виняй @@й ани @@хъ эвицӀ.хъийа лагьа @@ди @@на , куьн , лагьа @@на , асвальт @@е @@л аватна @@е , лагьа @@на .
Къведа и гада .	къве @@да и гада .
Жемятдизни хвеши жеда иер жаван пачагь хьана .	жемятдизни хвеши жеда иер жаван пачагь хьа .
Яни ки , и кьилин тӀвар язва	я @@ни ки , и кьил @@ди @@н тӀвар я @@зва
Везиятда амаш ма .	везият @@е ама @@ш ма .
Серинвал къачуз .	серин @@вал къачун @@з .
Иниз хтанва зун , хуьруз .	иниз @@з хта @@нва зун , хуьр @@ди @@з .
Рушарин арадай им чара хьана , акуртӀа , лагьана , зун къвез акуна , заз мейил къалурна , лагьана .	руш @@ар @@ди @@н арадай им чара хьун @@на , акур @@тӀа , лугьун @@на , зун къвез акун @@на , за @@з мейил къалурун @@на , лугьун @@на .
« Гьа~бередани зун вуна къачуна тур », лугьуда .	« гьа.береда @@е @@ни зун вун @@ди къачу @@на тур », лугьу @@да .
Зазни дуьз кичӀе хьана .	за @@з @@ни дуьз кичӀе хьун @@на .
Мицибуру гвадардай къендер .	мицибур @@ди вегьена @@да @@ай къенд @@ар .
Гьа , сонра ..	гьа , сонра ..
« Им ичӀерна гьа пачагьдин винелай лагь хьи » лугьуда , « вакай я кицӀ хьурай , я вак хьурай ».	« Им ичӀерна @@на гьа пачагь @@ди @@н винелай @@л @@ай лагьа хьи » лугьу @@да , « ва @@к @@ай я кицӀ хьурай @@ай , я вак хьурай @@ай ».
Чаз чизва ки , энциклопедияйар , алифбарал физва .	чи @@з чи @@зва ки , энциклопедияйар @@ар , алифбарал @@ди @@л фе @@зва .
Вучиз гьада и инсан вилик эцигнава , мицид кьулухъ эцигнава ?	вуч @@ди @@з гьада и инсан вилик эциг @@нва , мицид кьулухъ эциг @@нва ?
« Цайлапанрикай кьиса ». 00 : 59	« Цайлапан @@ди @@к @@ай кьиса ». 00 : 59
« Гьагь », лугьуда « и руш чи гъиляй акъатна икьван иер руш ».	« Гьагь », лугьу @@е « и руш чи гъиляй акъат @@на икьван иер руш ».
Я стха , вуч , им вуч месела я , и гьалда ци туна кицӀ ?	я стха , вуч , и @@м вуч месела я , и гьал @@е ци тун @@на кицӀ ?
Гатдамаз , вичи лагьана , мад зун дели хьанвай артух , лагьана .	гатин @@да @@нмаз , вич @@ди лугьун @@на , мад зун дели хьун @@нва @@й артух , лугьун @@на .
« Накьвар », лагьана , « за гъана муьтлег ви вилер сагъарна кӀанда », лагьана .	« накьв @@в @@ар », лагьа @@на , « за гъана @@на муьтлег ви вил @@ер сагъарна @@ар @@на кӀан @@е », лагьа @@на .
Польшадай аниз , Берлиндиз	Польша @@ай ани @@з , Берлин @@ди @@з
Хтайла и хкведай рекье и рушаз аквазвай хьи , гьич и гада шад туш .	хта @@й @@ла и хкве @@е @@ай рекь @@е и руш @@ди @@з аквазва @@зва @@ай хьи , гьич и гада шад туш .
Вунани лагь хьи ,» лугьуда , « зи пӀузарар хер хьанва , са къапина аваз це кван вуна заз ».	вун @@ди @@ни лагьа хьи ,» лугьу @@да , « зи пӀузарар @@ар @@ар хер хьа @@нва , са къапина @@ди @@на ава @@з це кван вуна за @@з ».
« Зун », лагьана , « фена инсанрин арада гьатда , акван белке зи кьисметда ава .»	« зун », лагьа @@на , « фе @@на инсан @@ди @@н арада @@е гьатда @@да , акван белке зи кьисметда @@е ава .»
ЧӀехи гадади лагьана , « чан буба », лагьана , « за изатна фена », лагьана , « гъида », лагьана .	ЧӀехи гада @@ди лагьа @@на , « чан буба », лагьа @@на , « за изатна @@на фе @@на », лагьа @@на , « гъида @@да », лагьа @@на .
Вобщем , рази хьанач ибур , имидини чи бубади лагьана ки , ваъ !	вобщем , рази хьа @@на @@ч ибур , ими @@ди @@ни чи буба @@ди лугьун @@на ки , ваъ !
Чпивай къачуз хьаначтӀани къеле , элкъвена хъфенвач ибур .	чпи @@в @@ай къачун @@з хьун @@на @@ч @@тӀа @@ни къеле , элкъвен @@на хъфин @@нва @@ч ибур .
Са арадлай элкъвена , фена , мици чкадлай элкъвена хтана .	са арадлай элкъвез @@на , фе @@на , мици чка @@ди @@л @@ай элкъвез @@на хта @@на .
атана и чи вине тарафара векьер ава ...	атун @@на и чи винелай тарафар @@е векьер @@ер ава ...
Ийимир желб , чан Безханум ( мани лугьузва )	ийи @@мир желб , чан Безханум ( мани лугьун @@зва )
Ибурузни жаза це » лагьана .	ибурузни жаза це » лагьа @@на .
Алатда мадни са гьафте .	алатун @@да мадни са гьафте .
ЯхцӀур югъ хьайидилай сура вун фида гьамамдиз , фена цӀийи пекер алукӀна аяр хьана хкведа , гьа~береда чна мехъерарда .	ЯхцӀур югъ хьа @@ай @@ди @@ла @@ай сура вун фе @@е гьамамда @@ди @@з , фе @@на цӀийи пекер алукӀна @@на аяр хьа хкве @@да , гьа.береда @@е чна мехъерар @@ар @@да .
Гагьатзава .	гагьатун @@зва .
Чунни инал хтана .	чун @@ни инал хта @@на .
Гададини « я пачагь » лугьуда , « вун сагърай .	гада @@ди @@н @@ди « я пачагь » лугьу @@да , « вун сагъарна @@рай .
Инай виняй анихъ эвицӀ~хъийа лагьана , куьн , лагьана , асвальтдал аватда , лагьана .	ина @@й виняй @@й ани @@хъ эвицӀ.хъийа лагьа @@ди @@на , куьн , лагьа @@на , асвальт @@е @@л аватна @@е , лагьа @@на .
Къведа и гада .	къве @@да и гада .
Фена къаткана жуван чкадал , вил ахвара фена зу .	фин @@на къаткун @@на жув @@ди @@н чка @@ди @@л , вил ахвар @@е фин @@на зи .
Къачуз хьанвач Миграгъ къеле .	къачун @@з хьа @@нва @@ч Миграгъ къеле .
Зунни эрменидихъ терсина	зун @@ни эрмени @@ди @@хъ терсина
Зун хьуй ваз яр , чун бахтавар	зун хьун @@й Ваз яр , чун бахтавар
Хтана ибур и вилаятдиз .	хта @@на ибур и вилаятда @@ди @@з .
Литвада хейлаг чӀавалди хьана , ахпа чун фенава немецаринни Литвадин границадиз .	Литва @@е хейлаг чӀав @@ди @@л @@ди хьа @@на , ахпа чун фе @@нва немецар @@ди @@н @@ни Литва @@ди @@н граница @@ди @@з .
Зазни и гадади суьгьбетда , ихтилатда са .	за @@з @@ни и гада @@ди суьгьбетарна @@да , ихтилат @@да са .
Пара хъсан акьуллу кицӀ тир .	пара хъсан акьуллу кицӀ тир .
Чаз кишинзава лагьана за , чаз	чи @@з кишинни @@н @@зва лагьа @@на за , чи @@з
Ахьтин береда цӀийиз марф жезвач эхьир .	ахьтин бере @@е цӀийи @@з марф же @@зва @@ч эхьир .
Къеледин и жигъирарни галаз вири цацарив , гьахьтин шейэрив кӀевнавай тир лугьуда , рехъ арабриз чир тахьурай лугьуз , гьа девирда рекьер чир тахьурай лугьуда .	къеле @@ди @@н и жигъир @@ар @@ни галаз вири цацар @@ди @@в , гьахьт @@ди @@н шей @@ар @@ди @@в кӀевин @@нва @@й тир лугьун @@да , рехъ араб @@ар @@ди @@з чир тахьун @@ар @@ай лугьун @@з , гьа девир @@е рекь @@ар чир тахьун @@рай лугьун @@да .
За лагьана за , кишинзава ма чаз .	за лагьа @@на за , кишинни @@н @@зва ма чи @@з .
Кани ярдиз ви рикӀе лугьудай гафар амани ?	кани @@ди яр @@ди @@з ви рикӀ @@е лугьу @@е @@й гаф @@ар ама @@ни ?
Вирини ада кхьана мугьубатдикай , ашкъидикай .	вири @@ни ада кхьин @@на мугьубат @@ди @@к @@ай , ашкъи @@ди @@к @@ди @@ай .
Гададини « хьуй ма », лугьуда .	гада @@ди @@н @@ди « хьуй ма », лугьу @@е .
« Вуна эвера а гададиз », лугьуда , « гевгьеррин иесини гъиз ча жуваз ».	« Вун @@ди эвера а гада @@ди @@з », лугьу @@да , « гевгьерар @@ди @@н иеси @@ни гъиз ча жува @@з ».
Вахт алатна идакай са пара иер , хур еке , верци са хъсан кицӀ хьана .	вахт алатун @@на идани @@к @@ай са пара иер , хур еке , верци са хъсан кицӀ хьун @@на .
Лейли ваз са кӀани яр хьуй	лейли Ваз са кӀан @@ди яр хьуй
ахпа фена чун паркиниз Дербентдин ,	ахпа фин @@на чун парк @@ди @@н @@з Дербентда @@ди @@н ,
« Хьуй », лугьуда .	« Хьуй », лугьу @@да .
Ибурни амна , хкведа и гадани руш … гадани руш хкведа ибур чпин вилаятдиз .	Ибурни амна , хкве @@да и гада @@ни руш … гада @@ни руш хкве @@да ибур чпин вилаятда @@ди @@з .
Зу аял ава Дербентда	зу аял ава Дербентда @@е
А чӀавуз фу жува чурчазвайди тир ...	а чӀаву @@з фу жув @@ди чурча @@зва @@й @@ди тир ...
Вичин мурад лугьузва .	вич @@ди @@н мурад лугьун @@зва .
Межлис хъсан фена , са къанни~вад нефер кас авай , дишегьлиярни авай , певицаярни авай .	межлис хъсан фин @@на , са къанни.вад нефер кас ава @@й , дишегьлиярни @@ар @@ни ава @@й , певицаярни @@ар @@ни ава @@й .
Анадырдиз зенгна .	Анадырдай @@ди @@з зенгин @@на .
Эхир лагьана хьи , чна са жуьре кьилиз акъудна кӀанда чи ният .	эхир лугьун @@на хьи , чна са жуьре кьил @@з акъудун @@на кӀан @@да чи ният .
Пуд къанни цӀуьд лагьай йисиз эскервиле авайла зун ,	пуд къанни цӀуьд лагьа @@ай йис @@ди @@з эскервил @@е ава @@й @@ла зун ,
Ун , хъфейдалай сонра и диде бубадихъ галаз гафарда , дахадихъ галаз гафарда , чи стхадихъ галаз .	ун , хъфин @@й @@да @@ла @@й сонра и диде буба @@ди @@хъ галаз гафарун @@да , даха @@ди @@хъ галаз гафарун @@да , чи стха @@ди @@хъ галаз .
Эверда рессамдиз .	Эвера @@е рессам @@ди @@з .
Гьа вили чкадиз зун фида .	гьа вили чка @@ди @@з зун фин @@да .
Вични заставадал алай лугьуда .	вич @@ни заставада @@л ала @@ай лугьун @@да .
Алатна са кьадар вахт , заз мадни ван къвезва хьи , беес , кицӀ Исабалади вичин цӀийи хьайи къугьумдиз багъишна .	алатун @@на са кьадар вахт , за @@з мад @@ни ван къве @@зва хьи , беес , кицӀ Исабала @@ди вич @@ди @@н цӀийи хьун @@ай къугьум @@ди @@з багъиш @@на .
Ана .	ана .
Хтана балкӀан , « Гьаа », лагьана « гила чавай физ жеда » лагьана , « пачагьдин руш гъиз ».	хта @@на балкӀан , « Гьаа », лагьа @@на « гила чавай @@ай фе @@з же @@да » лагьа @@на , « пачагь @@ди @@н руш гъида @@з ».
Кьвед~лагьай гадади лагьана « Зун фида буба », лагьана , « исятда за гъида », лагьана .	кьвед.лагьай гада @@ди лагьа @@на « зун фе @@е буба », лагьа @@на , « исятда @@е за гъида @@да », лагьа @@на .
Рехъ са кӀадар фейдалай къулухъ абурин вилик са еке къван ахъатзава , чӀахмахдин къван .	рехъ са кӀадар фе @@й @@да @@ла @@ай къулухъ абур @@ди @@н вилик са еке къван ахъатун @@зва , чӀахмахдин @@ди @@н къван .
Аялар физ рукариз , анриз .	аял @@ар фин @@з руказ @@ар @@ди @@з , анриз .
Ваз тагудай гевгьерар авайди яни », лугьуда .	ва @@з тагудай @@да @@ай гевгьерар @@ар ава @@ай @@ди яни », лугьу @@да .
Гьадалай къери мад кьвед , пуд цех аваз хьанва гьана .	гьада @@ла @@ай къери мад кьвед , пуд цех ава @@з хьа @@нва гьа @@на .
Жаваб я ашукь гада	жаваб я ашукь гада
И береда зу рикӀал са хъсан са кьиса атана .	и бере @@е зу рикӀ @@ди @@л са хъсан са кьиса атун @@на .
АкуртӀа , лагьана ,	акун @@тӀа , лугьун @@на ,
Эвел ругуд варз служитна за Новгородда , под Ленинградом .	эвел ругуд варз служитин @@на за Новгородда @@е , под Ленинградом .
Эвли хьана , аялар хьанва гьабуризни .	эвли хьун @@на , аял @@ар хьун @@нва гьабур @@ди @@з @@ни .
Заз яд хъваз кӀанзавай тир , туьтер къуру хьанвай .	за @@з яд хъва @@з кӀан @@зва @@й тир , туьт @@ар къуру хьун @@нва @@й .
АкуртӀа руша сакӀани мейил къалурзавач .	акьун @@ай @@тӀа руш @@ди сакӀани мейил къалурун @@зва @@ч .
Им са мелимди гваз фена векьиз .	им са мелимди гваз фе @@на векьер @@ди @@з .
Вичин хва рекьиз кӀан жени ?	вич @@ди @@н хва рекь @@ди @@з кӀан жени ?
Чунни чуьнуьх~хьана къвазна .	чун @@ни чуьнуьх.хьана @@на къвазна @@на .
Иниз хтанва зун , хуьруз .	иниз @@з хта @@нва зун , хуьр @@ди @@з .
« Чан къари баде » лугьуда , « ваз руш кӀандани », лугьуда , « ваз са бала кӀандани », лугьуда ?	« Чан къари баде » лугьу @@да , « ва @@з руш кӀан @@да @@ни », лугьу @@да , « ва @@з са бала кӀан @@да @@ни », лугьу @@да ?
« Пара вун фикирдиз фенва хьи ».	« Пара вун фикир @@ди @@з фе @@нва хьи ».
« Канивал залан дерт я	« Кан @@ди @@вал залан дерт я
Кьуьзуь са итем .	кьуьзуь са итем .
И~арада балкӀанди « са фикирарни ийимир » лагьана , « за ваз куьмекда » лагьана .	И.арада балкӀан @@ди « са фикир @@ар @@ни ийи @@мир » лагьа @@на , « за ва @@з куьмек @@да » лагьа @@на .
Адалай кьулухъ хуьр артух амач , яшайиш амач ана .	ада @@л @@ай кьулухъ хуьр артух ама @@ч , яшайиш ама @@ч ана .
Вообще , адетар хъсан тир хуьруьн .	вообще , адет @@ар хъсан тир хуьр @@ди @@н .
и луьтквечини кьуна тухуда ибуру кутада кӀвале .	и луьтквечи @@ни кьуна @@на туху @@да ибур @@ди кутада @@да кӀвал @@е .
ГьакӀ хьайила и дагъвийриз чпиз~чпиз~мукьвал характер авайди я , чпин философия авайди я .	ГьакӀ хьун @@ай @@ла и дагъви @@ар @@ди @@з чпиз.чпиз.мукьвал характер ава @@ай @@ди я , чпин философия ава @@й @@ди я .
И палкан гьакӀ галатнавайди хьана ибурин , пара зейиф палкан хьана , галатнавай палкан .	и палкан гьакӀ галатун @@нва @@й @@ди хьун @@на ибур @@ди @@н , пара зейиф палкан хьун @@на , галатун @@нва @@й палкан .
Зунни гила гьатна къене за гьарайзу .	зун @@ни гила гьатун @@на къене за гьарайун @@зу .
Ахъаюнмаз лув~гана атана и къуш ацукьда рушан къуьнел .	ахъаюнмаз @@з лув.гана @@на атай @@на и къуш ацукьна @@да руш @@ди @@н къуьнел @@е @@л .
Заз ван атана гила кӀурцӀулар хана .	за @@з ван атун @@на гила кӀурцӀул @@ар хъун @@на .
Эй зи гатфар уьмурдин цуьк	эй зи гатфар уьмурдин @@ди @@н цуьк
И жанавурри гьужумна завай хпер къакъудна са яхцӀур гьайван .	и жанавур @@ди гьужум @@на за @@в @@ай хпер къакъудна @@на са яхцӀур гьайван .
ашар ийидай гьана ...	аш @@ар ийи @@да @@ай гьана ...
Руш ракъайтӀа гьикӀ жеда ?»	руш ракъайтӀа гьикӀ же @@да ?»
Им дейесен кӀевиз ксанвай хьтин тир .	им дейесен кӀевиз ксун @@нва @@й хьтин тир .
КицӀ ви , лагьана , вутӀнатӀани гьадаз чида .	кицӏ ви , лугьун @@на , вутӀ @@на @@тӀа @@ни гьада @@з чин @@да .
Себриллагьахъ акъвезва чун .	себриллагьахъ акъвен @@зва чун .
Франциядай Бельгиядиз , ахпа Голландиядиз .	Франция @@ай Бельгия @@ди @@з , ахпа Голландия @@ди @@з .
Ви дердинай къураз хьана	ви дерд @@ди @@н @@ай къуран @@з хьун @@на
Ина йиф хьана чи .	ина йиф хьа @@на чи .
Ваз аваш тӀа ви яр белке	Ваз ава @@ш тӀа ви яр белке
Таниш хьана , жув чирна гьадаз .	таниш хьун @@на , жув чирин @@на гьада @@з .
Акъадарда и пачагь ибуру ламрал , балкӀандал акъадарда , ламрал акъадарда яда , цӀайни ахъайда , им гьи хуьрей агъуз .	акъадарда и пачагь ибур @@ди ламрал , балкӀан @@л акъадарда , ламрал акъадарда яда , цӀайни ахъайда , им гьи хуьрей агъуз .
Бес , лагьана , вуна яратмиша ма .	бес , лугьун @@на , вун @@ди яратмишин ма .
« Бес за вучин », лагьана , « зун гьин патахъ фин », лагьана , « Зун гьиниз фин », лагьана ?	« Бес за вуч @@ди @@н », лагьа @@на , « зун гьин пата @@хъ фе @@н », лагьа @@на , « зун гьиниз фе @@н », лагьа @@на ?
Заз мад вуш лугьуз кӀанзва ?	за @@з мад вуш лугьун @@з кӀан @@зва ?
Рушани лугьуда хьи ,» лугьуда , « эвеца , жува къачу ».	руш @@ди @@ни лугьу @@да хьи ,» лугьу @@да , « эвеца , жув @@ди къачу ».
Занни а чи хуьруьн ... хуьр пара ана авайди яман , гьундуьрда ...	за @@н @@ни а чи хуьре @@ди @@н ... хуьр пара ана ава @@й @@ди я , гьундуьрда ...
Вун инсан туш .	вун инсан туш .
… Седакъет ханум гьа еке Шагьдагъ я , чаз аквазвай .	… Седакъет ханум гьа еке Шагьдагъ я , чи @@з аквазва @@зва @@ай .
За вун тухвана гьадаз гана кӀанзава .	за вун тухвана @@на гьада @@з гана кӀан @@зва .
КилигайтӀа лагьана , вичиз акур БацӀ амач лагьана , кицӀ амач лагьана .	Килигун @@ай @@тӀа лугьун @@на , вич @@ди @@з акун БацӀ ама @@ч лугьун @@на , кицӀ ама @@ч лугьун @@на .
""" Мама , мама "" гьарайзу зани ."	""" Мама , мама "" гьарайун @@зу за @@ни ."
Руш ракъайтӀа гьикӀ жеда ?»	руш ракъайтӀа гьикӀ же @@да ?»
Зун са тӀимил мукьвал фена .	зун са тӀимил мукьвал фин @@на .
Зи кцӀизни паспорт авач , заз чизва .	зи кицӏ @@ди @@з @@ни паспорт ава @@ч , за @@з чин @@зва .
« Она~гуьре » лагьана , « чаз пачагьни авач » лагьана .	« Она.гуьре » лагьа @@на , « чи @@з пачагь @@ни ава @@ч » лагьа @@на .
Гила Безханума жаваб гузва идаз :	гила Безханум @@ди жаваб гун @@зва ида @@з :
хтана кӀанда хуьруьз ,	хтун @@на кӀан @@да хуьр @@ди @@з ,
« Суракьиз шумуд йисар ви гелерихъ гелкъвена зун .	« Суракьиз шумуд йис @@ар ви гелерихъ @@хъ гелкъвен @@на зун .
Идазни це жаза » лагьана .	идани @@з @@ни це жаза » лагьа @@на .
Имани ван къведа и везирриз , кьада и пачагь , тухуда има , эцигда , са кӀвале кутада .	има @@ни ван къве @@да и везирар @@ди @@з , кьада @@е и пачагь , туху @@да има , эциг @@да , са кӀвал @@е кутада @@да .
« Хьуй » лугьуда гададини .	« Хьуй » лугьу @@да гада @@ди @@н @@ди .
рекъелай пенжердай къене авайбур акъвазва	рекъ @@е @@л @@ай пенжер @@ай къен @@е авайбур акъваз @@зва
« Ша », лугьуда « чна » лугьуда « меслятдив ийин .	« Ша », лугьу @@да « чна » лугьу @@да « меслятдив @@в ийи @@н .
Эхир пара фикирайдалай сонра руш ацукьарна луьткведа , ракъуда и руш луьткведаваз тӀва патахъ .	эхир пара фикирайдалай сонра руш ацукьарна луьткве @@е , ракъуда и руш луьткведаваз тӀва патахъ .
Кани яр , ваз ви рикӀе лугьудай гафар амани ?»	кан @@ди яр , ва @@з ви рикӀ @@е лугьу @@да @@й гаф @@ар ама @@ни ?»
Эйиб айир жаваб че заз	эйиб айин @@ай жаваб че за @@з
Идаз ван~хьанач .	идани @@з ван.хьун @@ч .
И дастан инал куьтях хьана , ашукь метлебдин къерардиз атана .	и дастан ина @@л куьтях хьун @@на , ашукь метлеб @@ди @@н къерар @@ди @@з атун @@на .
Случайно аватна ки , авариядиз аватна чун .	случайно аватун @@на ки , авариядиз @@ди @@з аватна @@на чун .
Гададини « я пачагь » лугьуда , « вун сагърай .	гада @@ди @@н @@ди « я пачагь » лугьу @@да , « вун сагъарна @@рай .
« Икьван иер руш » лугьуда фикирдай , « гьикӀ лагьана за », лугьуда , « и гададив тан има ?»	« Икьван иер руш » лугьу @@да фикир @@да @@ай , « гьикӀ лагьа @@на за », лугьу @@да , « и гада @@ди @@в тан има ?»
Бес за гаф гудий~вал хьуй ашукьдиз .	бес за гаф гудий.вал хьуй @@й ашукь @@ди @@з .
( Ву ) На чирадаз гаф гана ки ,	( Ву ) На чирадаз @@ди @@з гаф гун @@на ки ,
Эверда рессамдиз .	Эвера @@е рессам @@ди @@з .
А мицида куьтни ийизваш .	а мицид @@ди куьтни ийи @@зва @@ш .
и чӀавуз иналай къаз ибур вилик хъфена ...	и чӀав @@ди @@з ина @@л @@ай къаз и @@бур вилик хъфена @@на ...
За кӀелдин береда ктабда Седакъет ханума ругь аквазва .	за кӀел @@ди @@н бере @@е ктаб @@е Седакъет ханум @@ди ругь аквазва @@зва .
Фида и гадади и гевгьерар гъана гуда пачагьдиз , пачагьни тамашна пара иер гевгьерар къахчуна рахкуда и гада .	фе @@е и гада @@ди и гевгьерар @@ар гъана @@на гуда @@да пачагь @@ди @@з , пачагь @@ни тамаша @@на пара иер гевгьерар @@ар къахчуна @@на рахкуда @@да и гада .
Чунни инал хтана .	чун @@ни инал хта @@на .
Безханумахъ галаз санал амукьин терефдар хьана .	Безханум @@ди @@хъ галаз санал амукьун @@н терефдар хьун @@на .
Эхир , не~исе , им къуна агъана .	эхир , не.исе , им къунва @@на агъин @@на .
Ашукь Нуьсрет , лагьана , бес , лагьана , жедашни , лагьана , зу тӀварчиз вуна са шеъ кхьайтӀа ?	ашукь Нуьсрет , лугьун @@на , бес , лугьун @@на , жеда @@ш @@ни , лугьун @@на , зу тӀвар @@ди @@з вун @@ди са шеъ кхьин @@й @@тӀа ?
Кьве стхадизни за хъсандик мехъерарна .	кьве стха @@ди @@з @@ни за хъсан @@ди @@к мехъерар @@ар @@на .
Са гадади , са дустини вичин рикӀ ахъайзава рушаз .	са гада @@ди , са дуст @@ди @@ни вич @@ди @@н рикӀ ахъайун @@зва руш @@ди @@з .
ГьакӀ хьана за и кӀурцӀулдиз са тӀварни ганвай – БацӀ лугьузвай идаз за .	ГьакӀ хьун @@на за и кӀурцӀул @@ди @@з са тӀвар @@ни гун @@й – БацӀ лугьу @@зва @@й идани @@з за .
Акъахда и гада балкӀандал , фида ибур гьуьлуьн кӀануз .	акъах @@е и гада балкӀан @@л , фе @@да и @@бур гьуьлун @@ди @@н кӀан @@ди @@з .
Гадани гъавурда~акьуна хьи , гьуьлуьн шив кьейи чӀал .	гада @@ни гъавурда.акьуна @@на хьи , гьуьлун @@ди @@н шив кьена @@ай чӀал .
чи хуьре , тагьминан са вад йис вилик .	чи хуьр @@е , тагьминан са вад йис вилик .
Адаз са рушни , са гадани ава .	а @@ди @@з са руш @@ни , са гада @@ни ава .
Ида лагьана , зун фидамаз Ахтынский райондиз , фейла акуртӀа , булахдин кьилел са десте рушар ала , лагьана .	ида лугьун @@на , зун фе @@да @@нмаз Ахтынский райондиз @@ди @@з , фин @@й @@ла Акуртӏа , булах @@ди @@н кьил @@е @@л са десте руш @@ар ала , лугьун @@на .
Берлиндай Франциядиз ,	Берлин @@ай Франция @@ди @@з ,
ГьакӀ хьайла , лугьузва , са рекъиз атана , чна , лугьузва , за вахъ галаз мад ваъ гаф амач .	ГьакӀ хьун @@й @@ла , лугьун @@зва , са рекъ @@ди @@з атун @@на , чна , лугьун @@зва , за ва @@хъ галаз мад ваъ гаф ама @@ч .
Хтана ибур и вилаятдиз .	хта @@на ибур и вилаятда @@ди @@з .
Мамани мици , кӀвала къатканава зунни и патал алай кӀвала къатканава .	мама @@ни мици , кӀвал @@е къатка @@нва зун @@ни и патал ала @@й кӀвал @@е къаткун @@нва .
Ана мугьарибе хьана .	ана мугьарибе хьа @@на .
БацӀ вахкана Исабаладив .	БацӀ вахгун @@на Исабала @@ди @@в .
Рушахъ галазни мехъерарна ибуру башламишда ина пачагьвализ .	рушахъ галаз @@ни мехъерарна ибуру башламишда ина пачагьвализ .
Сонра хвеши хьана , регьет хьана ма .	сонра хвеши хьун @@на , регьет хьа @@на ма .
Эвел са чаяр хъван , са ял ягъан , ахпа истирагьатайдалай сонра квекай сад за хкягъда », лугьуда .	эвел са чаяр @@ар хъван , са ял ягъана @@н , ахпа истирагьатайдалай @@ай @@да @@ла @@й сонра квекай @@ай сад за хкягъа @@да », лугьу @@да .
« Ваз вуч хьанва », лагьана ?	« Ваз вуч хьа @@нва », лагьа @@на ?
А Севда халади къизил тупӀаларни къгъанава ...	а Севда хала @@ди къизил тупӀал @@ар @@ни къачун @@нва ...
Фидайла , за ваз лугьуда », лагьана , « гьина аватӀа накьв ».	фида @@й @@ла , за ва @@з лугьу @@да », лагьа @@на , « гьина ава @@тӀа накьв ».
гьанай частиниз зенгна	гьан @@ай части @@н @@ди @@з зенги @@на
И руш эгекьайла гадади лугьуда « я руш », лугьуда , « заз капашда авай яд це тӀун » лугьуда .	и руш эгекьайла @@ай @@ла гада @@ди лугьу @@да « я руш », лугьу @@да , « за @@з капаш @@е ава @@ай яд це тӀун » лугьу @@да .
Вунани лагь хьи ,» лугьуда , « зи пӀузарар хер хьанва , са къапина аваз це кван вуна заз ».	вун @@ди @@ни лагьа хьи ,» лугьу @@да , « зи пӀузарар @@ар @@ар хер хьа @@нва , са къапина @@ди @@на ава @@з це кван вуна за @@з ».
Вич хъфена райондиз лагьана .	вич хъфин @@на райондиз @@ди @@з лугьун @@на .
Ваъ , лугьузва .	ваъ , лугьун @@зва .
« А бере », лугьуда , « адакай я кицӀ жеда лугьуда , я вак .	« А бере », лугьу @@да , « ада @@к @@ай я кицӀ же @@е лугьу @@да , я вак .
Хтайла и хкведай рекье и рушаз аквазвай хьи , гьич и гада шад туш .	хта @@й @@ла и хкве @@е @@ай рекь @@е и руш @@ди @@з аквазва @@зва @@ай хьи , гьич и гада шад туш .
немецарихъ галаз .	немецар @@хъ галаз @@з .
Вири — гьым , къачурла кьулухь , агакьна Миграгъ къеледив .	вири — гьым , къачун @@ла кьулухь , агакьун @@на Миграгъ къеле @@ди @@в .
Назир муаллимди , мисал уьчуьн , мез ялна адан , ам тахурай , нефес амайла	назир муаллим @@ди , мисал уьчуьн , мез ял @@на ада @@н , ам тахур @@ай , нефес ама @@ай @@ла
« Она~гуьре » лагьана , « чаз пачагьни авач » лагьана .	« Она.гуьре » лагьа @@на , « чи @@з пачагь @@ни ава @@ч » лагьа @@на .
АкуртӀа заз , сад гагьатзава , … сад и чун … са мертебели бина я жи казарма , и казармадал зунни къачал дежурный я .	акуртӀа за @@з , сад гагьатна @@зва , … сад и чун … са мертебели бина я жи казарма , и казарма @@е @@л зун @@ни къачал дежурный я .
Ва къенин къалди а юлдаш чазди миннетдар я а гьаятдиз гуьре .	ва къе @@н @@ди @@н къал @@ди а юлдаш чаз @@ди миннетдар я а гьаят @@ди @@з гуьре .
« Дуьз лагьайтӀа , чи магьалда	« Дуьз лугьун @@й @@тӀа , чи магьалда @@е
« Я стха , вуна заз тапарармир , алцурармир , кицӀ вутӀ хьана зи ?»	« я стха , вун @@ди за @@з тапарар @@мир , алцурарда @@ар @@мир , кицӀ вутӀ хьун @@на зи ?»
Литвада хейлаг чӀавалди хьана , ахпа чун фенава немецаринни Литвадин границадиз .	Литва @@е хейлаг чӀав @@ди @@л @@ди хьа @@на , ахпа чун фе @@нва немецар @@ди @@н @@ни Литва @@ди @@н граница @@ди @@з .
Севастопольдиз рекъе туна .	севастополь @@ди @@з рекъ @@е ту @@на .
Гьисятда гьарад муьстекъил девлет хьанва , Азербайджанни муьстекъил девлет я .	гьисят @@е гьарад муьстекъил девлет хьун @@нва , Азербайджан @@ни муьстекъил девлет я .
Къе йифиз за абуруз вуч той кьадатӀа аку ».	къе йиф @@ди @@з за абур @@ди @@з вуч той кьадатӀа аку ».
Гьа , сонра , ахьтин вахт хьана ки , за жува фу чирчадай береда пичинал ...	гьа , сонра , ахьтин вахт хьа @@на ки , за жув @@ди фу чирча @@да @@й бере @@е пичин @@ди @@л ...
Элкъвезва .	элкъвен @@зва .
Фергьад хьана дагъ атӀуд ( а ) за	фергьад хьун @@на дагъ атӀуд ( а ) за
Эхъвез башламишна .	эхъвен @@з башламиш @@на .
Крарикай икӀ я ... Чун жи дидедин гьимаенда~йашамиш хьанва ...	крар @@ди @@к @@ай икӀ я ... чун жи диде @@ди @@н гьимаенда.йашамиш хьа @@нва ...
АтӀуз гана ибурун кьилерни .	атӀуз @@з га @@на ибур @@ди @@н кьил @@ер @@ни .
Анжах заз са шей чир~хьана ки ,	анжах за @@з са шей чир @@хьун @@на ки ,
Бес , лагьана , рушаз гьикӀ териф ийин ки , лагьана , бес , лагьана , ашукьдиз ида икьрар гун паталай , мугьубат сад жен паталай .	бес , лугьун @@на , руш @@ди @@з гьикӀ териф ийи @@н ки , лугьун @@на , бес , лугьун @@на , ашукь @@ди @@з ида икьрар @@ар гун пата @@л @@ди @@ай , мугьубат сад жен пата @@л @@ди @@ай .
Чан Безханум , чан Безханум	чан Безханум , чан Безханум
Вичин кьилел атай гьадисени ахъайда .	вичи @@н кьил @@е @@л атай @@й гьадисе @@ни ахъа @@й @@да .
а сев ягъун патал фенавай чун .	а сев ягъ @@н патал фин @@нва @@й чун .
« Вуна эвера а гададиз », лугьуда , « гевгьеррин иесини гъиз ча жуваз ».	« Вун @@ди эвера а гада @@ди @@з », лугьу @@да , « гевгьерар @@ди @@н иеси @@ни гъиз ча жува @@з ».
Зав вахча зи кицӀ .»	за @@в вахча зи кицӀ .»
Вичини тухвана кучукна лагьана .	вич @@ди @@ни тухун @@на кучукун @@на лугьун @@на .
Ибурузни и рушан шикил ахкуна ибуруни агь аладарда .	ибур @@ди @@з @@ни и руш @@ди @@н шикил ахкуна @@на ибур @@ди @@ни агь аладарда @@да .
Чунни инал хтана .	чун @@ни ина @@л хта @@на .
Фидайла , за ваз лугьуда », лагьана , « гьина аватӀа накьв ».	фида @@й @@ла , за ва @@з лугьу @@да », лагьа @@на , « гьина ава @@тӀа накьв ».
« Икьван иер руш » лугьуда фикирдай , « гьикӀ лагьана за », лугьуда , « и гададив тан има ?»	« Икьван иер руш » лугьу @@да фикир @@да @@ай , « гьикӀ лагьа @@на за », лугьу @@да , « и гада @@ди @@в тан има ?»
Ибурни чӀалах~жеда идал .	Ибур @@ни чӀалах.жеда @@е идаз @@л .
Хъфида зун Исабаладин гьейетдал : « Я стха , вуна гаф гайи туширни заз ?	хъфин @@да зун Исабала @@ди @@н гьаятдал @@е @@л : « Я стха , вуна гаф гун @@ай тушир @@ни зава @@з ?
Он не отвечает .	он не отвечает .
Чи заставадилай ам фенвач , вач чугъун хъайа ам чубандивай , жузун хъая ам чубандивай .	чи застава @@ди @@л @@ай ам фин @@нва @@ч , Вач чугъун хъайа ам чубан @@ди @@в @@ай , жузун хъая ам чубан @@ди @@в @@ай .
Идазни инал гьакӀ ятӀани ашукьди канивилин , мугьубатдин ам жеда ибурин арада , икьрар .	ида @@з @@ни ина @@л гьакӀ ятӀани ашукь @@ди канивал @@вал @@ди @@н , мугьубат @@ди @@н ам жен @@да и @@бур @@ди @@н арада @@е , икьрар @@ар .
Вот , кьуьруьдаказ икӀа .	вот , кьуьруьдаказ икӀа .
Вун кьван гейчек масан хьанач .	вун кьван гейчек масан хьун @@на @@ч .
Икьван крар хьайитӀани	икьван крар хьайи @@тӀа @@ни
« Бес за вучин », лагьана , « зи бубадин вилер сакӀани хъсан жезвач », лагьана .	« Бес за вуч @@ди @@н », лагьа @@на , « зи буба @@ди @@н вил @@ер сакӀани хъсан же @@зва @@ч », лагьа @@на .
Лугьузва ки , Безханума , « Уъ , зун канивилин къерардиз къведа , анжах , лугьузва , дидедин гафни сад хьана кӀанда .	лугьун @@зва ки , Безханум @@ди , « Уъ , зун кани @@ди @@вил @@ди @@н къерар @@ди @@з къвен @@да , анжах , лугьун @@зва , диде @@ди @@н гаф @@ни сад хьун @@на кӀан @@да .