Ncblo lcng nzrlimzng x lr Gwalekana esz' .	ncblo lcng nz @@rlimz @@ng x lr Gwalekana esz' .
Zbz sc tqwaipele tqnginipenge kraesz'mz .	zbz sc tq @@wai @@pe @@le tq @@ngini @@pe @@nge kraesz'mz .
Mrlz voomc x sc tqrtangrtipex nqvi lr legru kc tqdopx-ngrne mrkc wq .	mrlz vo @@o @@mq @@x x sc tq @@rtangr @@ti @@pe @@x nqvi lr legru kc tq @@do @@px @@ngr @@ne mrkc wq .
78 . Daniel Boerger X Doa lr Manyzdeng	78 . Daniel Boerger x doa lr ma @@nyz @@de @@ngq
Mz Zbqkranzlvqn li mz temz kxesz' , nzayrlwrpx-lxblr-krgr doa lr mztea , mz nzlcapqbzngr x nzalvztrngr nidr mz nqmq ngr mztea , nqmq sc gzpman , x nqmq ngr makxtr .	mz zbqkranzlvqn li mz temz kx @@esz' , nz @@a @@yrlwr @@px @@lxblr @@kr @@gr doa lr mztea , mz nz @@lc @@a @@pq @@bz @@ngr x nz @@alvztr @@ngr nidr mz nqmq ngr mztea , nqmq sc gzpman , x nqmq ngr makxtr .
Kx vcmc kc sc tqalvznetrpexng mz nqmq ngr nzalvztrngr x kabo badr da kx na-alvztr-ngrdr .	kx vo @@mq @@o kc sc tq @@alvz @@ne @@tr @@pe @@x @@lengq mz nqmq ngr nz @@alvztr @@ngr x ka @@bo badr da kx na @@alvztr @@ngr @@dr .
Pulis lc atwzlr-ngrm Mr Lore mrkc Tobaita .	pulis lc atwzlr @@ngr @@mq Mr Lore mrkc Tobaita .
X ninge kc tqyzlupe-moux Boo mz Jenwzri yiz 1956 .	x ninge kc tq @@yzlu @@pe @@mou @@x Boo mz Jenwzri yiz 1956 .
Vopxbzkr mz wop sc tqaglqpekr da kcng .	vo @@px @@bz @@kr mz wop sc tq @@a @@glq @@pe @@kr da kcng .
Buk Ngr Be Rnge :	buk ngr be r @@nge :
Nzoliqti nzvo-krm Filip , ncblo ngr Kwin Elisabet .	nz @@oliqti nz @@vo @@kr @@mq Filip , ncblo ngr Kwin Elisabet .
Yrlzx Bznwz , yrlztix kzdq doa olvz drtqde Dora Yati .	yrlz @@x Bznwz , yrlz @@ti @@x kzdq doa olvz drtq @@de Dora Yati .
Rpibo bade kx mclx ncblo esz'txu esablqpxm x mnc-epelzle kc nctq plastik .	r @@pi @@bo bade kx mc @@x ncblo esz'txu esablq @@px @@mq x mnc @@epe @@lz @@le kc nctq plastik .
Rpibo badr kx , “ Dakc tqpi pripekt kx mcle x trmcleu nide sele .	r @@pi @@bo badr kx , “ da @@kc tq @@pi pripekt kx mc @@le x tr @@mc @@le @@u nide sele .
Vzkr x mwitx-kzkr Poodo , mz kzdq mztea nyz SSEC , murde pulis kc dalr makxtr lcde .	vz @@kr x mwi @@tx @@kz @@kr Poodo , mz kzdq mztea nyz SSEC , murde pulis kc dalr makxtr lcde .
Murde zbq kx nzwzngr leplz amrlx mz lrpzki .	murde zbq kx nz @@wz @@ngr leplz amrlx mz lrpzki .
Kx nzteslr kc ninge sc tzrpipemlr kx nangi ninge ofisz kratq mz lcsu .	kx nz @@tes @@lr kc ninge sc tz @@r @@pi @@pe @@mq @@lr kx na @@ngi ninge ofisz kra @@tq mz lcsu .
"Kzdu nidr nznemilr kx , "" Lrtzlvz kc bqpe drka' !"""	"kzdu nidr nz @@ne @@mi @@lr kx , "" lrtzlvz kc bq @@pe drka' !"""
Nrlc kx ngrlxobzle , nigr kc tqvzpebzkr mz Mama , tqrlxtipebzkr nzvo-krgr .	nrlc kx ngrlx @@o @@bz @@le , nigr kc tq @@vz @@pe @@bz @@kr mz mama , tq @@rlx @@ti @@pe @@bz @@kr nz @@vo @@kr @@gr .
A' rpimle , mrlz navzpx-krmle mz Mama Jon lni Lzpli .	a' r @@pi @@mq @@le , mrlz na @@vz @@px @@kr @@mq @@le mz mama Jon lni Lzpli .
"Nqvi lrde yzprlzm mz nua'mu scde bq ."""	"nqvi lr @@de yzpr @@lz @@mq mz nua'mu sc @@de bq ."""
Trtenge x lxenge drtqdr Melomate x Ilrmztangi .	trte @@nge x lxe @@nge drtq @@dr Melomate x Ilrmztangi .
Mzli lcde tqkaputr-ngrbz Aijz Nzlvz , Mama Jos Enre Wes sc tqmnc elr .	mzli lcde tq @@kaputr @@ngr @@bz Aijz Nzlvz , mama Jos Enre Wes sc tq @@mnc elr .
Mz yiz 1954 nide kc tqyrlz-ayrnr-ngrne .	mz yiz 1954 nide kc tq @@yrlz @@ayrnr @@ngr @@ne .
Nzvomqng badr doa lr manyzdeng x nzmnctrp Lwovz kxpipz , murde kzdq kc lrmztangi kzble sc tqmnc mz ma nyz Rik Biukan mrkc Bznwz .	nz @@vo @@mq @@ng badr doa lr ma @@nyz @@de @@ngq x nz @@mnc @@tr @@mq Lwovz kxpipz , murde kzdq kc lrmztangi kzble sc tq @@mnc mz ma nyz Rik Biukan mrkc Bznwz .
Nigr kcng tzmnctxpwz mz newz Tzlede , nigr kc tqmu-ngrbe mz nc nzlu kcng esz'mz x nc naq kc esz' .	nigr kcng tz @@mnc @@tx @@pwz mz newz Tzlede , nigr kc tq @@mu @@ngr @@be mz nc nzlu kcng esz'mz x nc naq kc esz' .
Dwaobzkr a' lvabetxpwzkr , murde gq kcng yrbutipeng mz lue .	dwa @@o @@bz @@kr a' lvabe @@tx @@pwz @@kr , murde gq kcng yrbu @@ti @@pe @@ng mz lue .
Krlc skul nyzdr Roman x yrmq kxetu r skul lcde , Mama Sevenoklck .	krlc skul nyz @@dr Roman x yr @@mq kx @@etu r skul lcde , mama Sevenoklck .
X nzrpimlr kx kc tqrpna'-ngrm lcsu kc waelas scgu trka .	x nz @@r @@pi @@mq @@lr kx kc tq @@rpna' @@ngr @@mq lcsu kc waelas sc @@gu trka .
Yrkrbzkr bade , sc tqrpipemle bagr kx , “ Mzli ka ninge kc narlxngiti-atepex , murde mc-angidrpex mz mzke' kxmu nzxplrkr x nzokatrkr drka' ne tzsiu lcng .	yrkr @@bz @@kr bade , sc tq @@r @@pi @@pe @@mq @@le bagr kx , “ mzli ka ninge kc na @@r @@lxngiti @@ate @@pe @@x , murde mc @@angidr @@pe @@x mz mz @@ke' kxmu nz @@xplr @@kr x nz @@okatr @@kr drka' ne tzsiu lcng .
Wisol lc dalr nzoliqkr leplz amrlx , murde lcsukxlvc scdr lr Japan sc tzlvcmqng nabomlr Luga .	wisol lc dalr nz @@oliq @@kr leplz amrlx , murde lcsu @@kx @@lvc sc @@dr lr Japan sc tz @@lvc @@mq @@ng na @@bom @@lr Luga .
Nzkapxmlr dabukr bona kcng li sc tzangcpebzlr mz Ncbr .	nz @@kapx @@mq @@lr dabu @@ngr bona kcng li sc tz @@a @@ngc @@pe @@bz @@lr mz ncbr .
"Rpibo bade kx , "" Tqyrkelvzx nc nzlu kc yrplatrngr narm mztupe ."""	"r @@pi @@bo bade kx , "" tq @@yrke @@lvz @@x nc nzlu kc yrpla @@tr @@ngr nar @@mq mz @@tu @@pe ."""
X krali vztr-kzpz glqlzmle Aijz , rtco-ngrde bxpizpx ncte li .	x kra @@li vz @@tr @@kz @@pz glq @@lz @@mq @@le Aijz , rtc @@o @@ngr @@de bxpiz @@px @@Ø nctq @@de li .
Zbz mz yiz kcng emwrngr mz nzwzngr lc , nzglxpe kzdung leplz nzwzngr lc , x doa nzkqlupeng kx nzprtr-kzpqng mz nzwz-lxblr-krgr badr .	zbz mz yiz kcng emwr @@ngr mz nz @@wz @@ngr lc , nz @@glx @@pe kzdung leplz nz @@wz @@ngr lc , x doa nz @@kqlu @@pe @@ngq kx nz @@prtr @@kz @@mq @@ng mz nz @@wz @@lxblr @@kr @@gr badr .
Luekxpiz ngr drka' kang kqlu mnqtipele , nzmulr drtqde namrlz .	luekxpiz ngr drka' kang kqlu mnq @@ti @@pe @@le , nz @@mu @@lr drtq @@de na @@mrlz @@Ø .
Nzrkalzmqngq , sc tzvzpe-kaing .	nz @@rkalz @@mq @@ngq , sc tz @@vz @@pe @@kai @@ng .
Rpibo kx , “ Trtingr , makxpele ninge blzmr nadq .”	r @@pi @@bo kx , “ trtingr , makx @@pe @@le ninge blzmr nadq .”
Mama lc nide lr Inglan x mnc Namc .	mama lc nide lr Inglan x mnc Namc .
23 . Mzdealwx Rlxngiti Mz Nzmc-krde Zmatq Ngr Nzrkatxngr Zyagox	23 . Mzdealwx r @@lxngiti mz nz @@mc @@kr @@de zmatq ngr nz @@r @@katx @@ngr zyagox
Sc tqrpnz'pebz kc , katris kc tu mz mqde x sc tqnepe .	sc tq @@r @@pnz' @@pe @@bz kc , katris kc tu mz mq @@de x sc tq @@ne @@pe .
Kx krlzlzbo kc mrkc tqplrkqtu , sc tzngrlalvztipelr ninge bingar .	kx krlz @@lz @@bo kc mrkc tq @@plrkqtu , sc tz @@ngrla @@lvz @@ti @@pe @@lr ninge bingar .
Mz nibr nzmu-krgr , nztelvzlr mz Menabz kc nyr nzangcti-ngrdr ncvr ngr bona , nc , muli dakxnzng kx yctxo x leu rdrng amrlx .	mz nibr nz @@mu @@kr @@gr , nz @@telvz @@lr mz Menabz kc nyr nz @@a @@ngc @@ti @@ngr @@dr ncvr ngr bona , nc , muli dakxnzng kx yctxo x leu r @@dr @@ngq amrlx .
Lrlvz tcprtrngr nanycde mqngr drka' kc tqtutxpxm mz naonrx .	Lrlvz tcprtr @@ngr nanyc @@de mqngr drka' kc tq @@tu @@tx @@px @@mq @@Ø mz naonrx .
Mz zbq kc navope-ngrgr , kxetu rgr rkatxm mnrgr br nr mc , blxget , lrpz x dakxnzng .	mz zbq kc na @@vo @@pe @@ngr @@gr , kx @@etu r @@gr r @@ka @@tx @@mq mnr @@gr br nr mc , blxget , lrpz x dakxnzng .
Zbz mzli kc tzmncpe-ngrmlr Mama Josis Balq nidr ncdr olvz rde , Elsie , nzprtr-kzpqng mz nzrtekqtrngr Natq Gct abzo mz yiz 1996 .	zbz mzli kc tz @@mnc @@pe @@ngr @@mq @@lr mama Josis Balq nidr ncdr olvz r @@de , Elsie , nz @@prtr @@kz @@mq @@ng mz nz @@r @@tekqtr @@ngr natq Gct abzo mz yiz 1996 .
Mz yiz 1934 kzdq lcsu sc Gzpman vom drtqde Aijz .	mz yiz 1934 kzdq lcsu sc gzpman vo @@mq drtq @@de Aijz .
Mzke' tqopxpe-ngrde nubla nzyrleti-krde mz lrpzki .	mz @@ke' tq @@opx @@pe @@ngr @@de nubla nz @@yrle @@ti @@kr @@de mz lrpzki .
Kx krlzlzbzkr ma kc , sc tqrlxtipebzkr toki mz kzdq mqngr drka' kx tutxpxm mz naonrx .	kx krlz @@lz @@bz @@kr ma kc , sc tq @@rlx @@ti @@pe @@bz @@kr toki mz kzdq mqngr drka' kx tu @@tx @@px @@mq @@Ø mz naonrx .
Kzdu mzli mrlc Narnztilolx , trtenge nzamcti mz nzwzti-krbzle ma nyz kzdung ncblo .	kzdu mzli mrlc Narnztilolx , trte @@nge nz @@amc @@ti mz nz @@wz @@ti @@kr @@bz @@le ma nyz kzdung ncblo .
10 . Nzmncpe-krgr Narnztilolx	10 . nz @@mnc @@pe @@kr @@gr Narnztilolx
X sc tqpipebzle kx waea lc trka-esz'ngr , nzmu nangi nigu enqmi yrkrtxtrku .	x sc tq @@pi @@pe @@bz @@le kx waea lc trka @@esz'ngr , nzmu na @@ngi nigu enqmi yrkr @@tx @@tr @@ku .
Yzuo Nabzlue x mwikr Ncnia .	yzuo Nabzlue x mwi @@kr Ncnia .
Mz vau r yiz 1956 ninge kc tqvopex mz Saotzn Kros 7 mrkc Alankaula .	mz vau r yiz 1956 ninge kc tq @@vo @@pe @@x mz Saotzn Kros 7 mrkc Alankaula .
X sc tzyzlupe-mopwzng .	x sc tz @@yzlu @@pe @@mou @@bz @@ngq .
Nzwzngr li kx mzli boitx nzwztr-krngeng elr .	nz @@wz @@ngr li kx mzli boi @@tx nz @@wz @@tr @@kr @@nge @@ngq elr .
73 . Gari Saemons Lalztq mz Nzycmnekr Lr Trmctu ka	73 . Gari Saemons lalztq mz nz @@ycmne @@kr lr trmctu ka
81 . Trpnzngr Kx Tum Mz Nibrgr	81 . trpnzngr kx tu @@mq mz nibr @@gr
X xlr-moukr mz temz Eprol kx lr Austrelia x Niu Silan nzokatrpe-kzlr Inglan .	x xlr @@mou @@kr mz temz Eprol kx lr Austrelia x Niu Silan nz @@okatr @@pe @@kz @@lr Inglan .
Mz 18 Jenwzri 1968 Kxetu r skul , Pilip Bomio vzm bange Mona Skul .	mz 18 Jenwzri 1968 kx @@etu r skul , Pilip Bomio vz @@mq @@Ø bange Mona Skul .
Doa lcde lu , drtqde Agnes Inaoxngr .	doa lcde lu , drtq @@de Agnes Inaoxngr .
Pibz Mwekati bade x rpibzle kx , eu , na-abzbzlr ena .	pi @@bz Mwekati bade x r @@pi @@bz @@le kx , eu , na @@abz @@bz @@lr ena .
Mzli kc tqyangr-kaipzkr nrwx vo .	mzli kc tq @@ya @@ngr @@kai @@pz @@kr nrwx vo .
45 . Nzrtangrtingr Lclr Teomo X Merikol Kranzlvqn Mz Mzli R Vea	45 . nz @@rtangrti @@ngr lclr teomo x merikol kranzlvqn mz Mzli R Vea
35 . Nzprtr-krnge Mz Skul Kc Veranaso	35 . nz @@prtr @@kr @@nge mz skul kc Veranaaso
Vo-ngrmle Nzryrngrkxtr kxmrna natekqtr mz Natqgu .	vo @@ngr @@mq @@le nzryrngrkxtr kx @@mrna na @@tekqtr mz Natqgu .
X Residen Komisina nidr mz DO nzvzo-kzng x nzmncng Auki .	x Residen Komisina nidr mz DO nz @@vz @@o @@kz @@ng x nz @@mnc @@ngq Auki .
Kx mncpex kc Alankaulz sc tqmcpex kx nike pim tzsiu Jon bange mrkc Nea da zpwxtx .	kx mnc @@pe @@x kc Alankaulz sc tq @@mc @@pe @@x kx nike pi @@mq tzsiu Jon bange mrkc Nea da zpwx @@tx .
Rpibo bade kx , “ Trmcwxu , a' kzdu doa lr skul ka nzvz-ngrmlr bange nzwrde tq , nzrpilr nakabo du kio nem nangi nadr , a' rpwa'-ngrbo badr .	r @@pi @@bo bade kx , “ tr @@mc @@x @@u , a' kzdu doa lr skul ka nz @@vz @@ngr @@mq @@lr bange nzwr @@de tq , nz @@r @@pi @@lr na @@ka @@bo du kio ne @@mq na @@ngi na @@dr , a' rpwa' @@ngr @@bo badr .
Vzpxbzkr me yc-lxlr , kzdq kc Japan sc tqrwzso raes mz lue .	vz @@px @@bz @@kr me yc @@lxlr , kzdq kc Japan sc tq @@r @@wzti @@o raes mz lue .
Zbz nigr kc tqvzpekr .	zbz nigr kc tq @@vz @@pe @@kr .
Lika nede tryclvzopeu mz nzmwa-krde ncboi kxkqlu , x nenq etunepx zlwz kz mz nzwq-krde mz nzvzdzpe-krm nepi wq .	lika ne @@de tr @@yc @@lvz @@o @@pe @@u mz nz @@mwa @@kr @@de ncboi kx @@kqlu , x nenq etu @@ne @@px zlwz kz mz nz @@wq @@kr @@de mz nz @@vz @@dz @@pe @@kr @@mq nepi wq .
Kx yrkrpxx kc mz nzalvztrngr yzlumc x ninge kc tqmncpex Nepa' .	kx yrkr @@px @@x kc mz nz @@alvztr @@ngr yzlu @@mq @@x x ninge kc tq @@mnc @@pe @@x Nepa' .
Zbz kzdq doa lr Isabel drtqde Daniel Dani x ninge tqpipem Bisop bagr kx nigr kx navzbz mz Mr Lore .	zbz kzdq doa lr Isabel drtq @@de Daniel Dani x ninge tq @@pi @@pe @@m bisop bagr kx nigr kx na @@vz @@bz mz Mr Lore .
Drka' nedr kc tqngi drtqde Gct .	drka' ne @@dr kc tq @@ngi drtq @@de Gct .
Mzli kcpwz xlrbzkr masingan kxkqlu rpnz'pe mz nabz nc nzlu kc .	mzli kcpwz xlr @@bz @@kr masingan kx @@kqlu r @@pnz' @@pe mz nabz nc nzlu kc .
Rtctx-ngrgr nqni kcng x nigr kcng tqngrlrpekr mz gq kcng .	rtc @@tx @@ngr @@gr nqni kcng x nigr kcng tq @@ngrlr @@pe @@kr mz gq kcng .
Metalo lcde mnc mz trmctu Nemya mrkc Nea .	Metalo lcde mnc mz Trmctu Nemya mrkc Nea .
Nigr kc tqmukr banyapu , pwrkilvc-ngrgr nzbxli-lvco-krmlr mz kzdq nar newz x mzli lcdepwz nzrpna'neope-krmlr .	nigr kc tq @@mu @@kr banyapu , pwrkilvc @@ngr @@gr nz @@bxli @@lvc @@o @@kr @@mq @@lr mz kzdq nar newz x mzli lcde @@pwz nz @@r @@pna' @@ne @@o @@pe @@kr @@mq @@lr .
Da Kx Mclx Kx Prtzting	da kx mc @@x kx prtz @@ti @@ngq
Krlc merikol kc kai .	krlc merikol kc kai .
09 . Nzrlasz-krgr Mztea Mzdxmingr	09 . nz @@rlasz @@kr @@gr mztea Mzdxmingr
Lrlvz vzm sc tqdwatrpekr ncdr brma .	Lrlvz vz @@mq @@Ø sc tq @@dwa @@tr @@pe @@kr ncdr brma .
67 . Mncx Mzlo Skul	67 . mnc @@x Mzlo Skul
"Nzrpibz tzsiu kcng kx , "" Nartwzobz da leplz mrkc Bwzng , murde kztegr kxnzkqlu sc tzmncng elr ."""	"nz @@r @@pi @@bz tzsiu kcng kx , "" na @@r @@twz @@o @@bz da leplz mrkc Bwzng , murde kzte @@gr kx @@nz @@kqlu sc tz @@mnc @@ngq elr ."""
Mzli kc tqalvc-lzbq-ngrgr ninge kc tqnepex .	mzli kc tq @@alvc @@lzbq @@ngr @@gr ninge kc tq @@ne @@pe @@x .
Mnckr badr kz kcng doa lr Gela .	mnc @@kr badr kz kcng doa lr Gela .
Rpibz Mzdealwx mz Mwekati kx , “ Pibz bade na-abzbzlr , murde kx tqmrlzx , ninge kc tqlxngiti-atex drka' nedr Gct .”	r @@pi @@bz Mzdealwx mz Mwekati kx , “ pi @@bz bade na @@abz @@bz @@lr , murde kx tq @@mrlz @@x , ninge kc tq @@lxngiti @@ate @@x drka' ne @@dr Gct .”
X temz otxpx esz' mou nzprtr-mopwq kcng bagr .	x temz otxpx esz' mou nz @@prtr @@mou @@mq kcng bagr .
Dzbede kcng li-lxblr , kzdq bomle ezpct x kzdq bomle kampi nyzdr lr Japan .	dzbede kcng li @@lxblr , kzdq bom @@le ezpct x kzdq bom @@le kampi nyz @@dr lr Japan .
Mz temz Jenwzri ngr yiz 1940 ninge kc tqatwzlrpe Dckta Fox Veranaso .	mz temz Jenwzri ngr yiz 1940 ninge kc tq @@atwzlr @@pe dckta Fox Veranaaso .
Nzvzmqng mrkc mz nabxbz kc skulboe ngr Alankaula nzpwxng .	nz @@vz @@mq @@ng mrkc mz nabxbz kc skulboe ngr Alankaula nz @@pwx @@ngq .
Sc tzvzbeng mrkc tqvongr nabr x trpnzngr lue ngrde x nzlu kxpo kcng tztwznedr sc tqyrkrpe x drtwrdr sc tqbrlx-kzpe mou .	sc tz @@vz @@be @@ng mrkc tq @@vo @@ngr nabr x trpnzngr lue ngr @@de x nzlu kx @@po kcng tz @@twz @@ne @@dr sc tq @@yrkr @@pe x drtwr @@dr sc tq @@brlxkz @@pe mou .
Silas Prpx , Anika Ikai , x kzdung kz leplz mou nzokatr-kzplr nigr mz nzryrngr nabzkxtrng .	Silas Prpx , Anika Ikai , x kzdung kz leplz mou nz @@okatr @@kz @@mq @@lr nigr mz nzryrngr nabz @@kx @@tr @@ngq .
Kzdq nrc kxetu vztrpz x rtclz-ngrde Aijz mz nartrkla .	kzdq nrc kx @@etu vz @@tr @@pz x rtc @@lz @@ngr @@de Aijz mz nartrkla .
A' nzmctrpemlr nigr , sc tzlvc-rlrupeng .	a' nz @@mc @@tr @@pe @@mq @@lr nigr , sc tz @@lvc @@rlru @@pe @@ng .
Dckta yrkrpxbz kc nzwz-krde sc tqmwitxpe mou mz Trmctu Nemya' .	dckta yrkr @@px @@bz @@Ø kc nz @@wz @@kr @@de sc tq @@mwi @@tx @@pe @@Ø mou mz trmctu Nemya' .
Tqrpibo namncpwz trpnzngr .	tq @@r @@pi @@bo na @@mnc @@pwz trpnzngr .
Trau trmatq-zlwzu mz drtwrnge a' krla tqmatq zlwz mz drtwrnge nzwzngr .	trau tr @@matq @@zlwz @@u mz drtwr @@nge a' krla tq @@matq zlwz mz drtwr @@nge nz @@wz @@ngr .
Zbz mz yiz 1936 Mzdealwx sc tqyagoxpe , nzyagox-krde etutx zlwz .	zbz mz yiz 1936 Mzdealwx sc tq @@yagox @@pe @@Ø , nz @@yagox @@kr @@de etu @@tx zlwz .
"Rpibo bade kx , "" Sore , Dckta !"""	"r @@pi @@bo bade kx , "" sore , dckta !"""
Ngrlrkr , ngrlrkr ma nyzgr mz trtenge x nigr kc tqama-atekr .	ngrlr @@kr , ngrlr @@kr ma nyz @@gr mz trte @@nge x nigr kc tq @@ama @@ate @@kr .
X klas e fom ngrde krlzbzle rlimz .	x klas e fom ngr @@de krlz @@bz @@le rlimz .
Rlaszkr Narnztilolx mz nzmncpe-krgr Bokapwr mz yiz 1930 .	rlasz @@kr Narnztilolx mz nz @@mnc @@pe @@kr @@gr Bokapwr mz yiz 1930 .
Kx trnzmcpelru kc me nzvzkilr , dzbedr kc tqlipe .	kx tr @@nz @@mc @@pe @@lr @@u kc me nz @@vz @@ki @@lr , dzbe @@dr kc tq @@li @@pe .
Prtrx mz dzbede lc navzng .	prtr @@x mz dzbede lc na @@vz @@ng .
Nc nzlu lcng trplrkqtuu , tqopilvz nqvi x trdou .	nc nzlu lcng tr @@plrkqtu @@u , tq @@opilvz nqvi x tr @@do @@u .
Napi-moupo merikol kcng tq tqngi testimcne scnge mz dckrlzde kc 14 .	na @@pi @@mou @@mq @@x merikol kcng tq tq @@ngi testimcne sc @@nge mz dckrlzde kc 14 .
Vzox prla teox bot , x xlrbo Mcnika Imztq yrnineopebz bange prla , rpile nangi nigr ncdr .	vz @@o @@x prla te @@o @@x bot , x xlr @@bo Mcnika Imztq yrni @@ne @@o @@pe @@bz bange prla , r @@pi @@le na @@ngi ni @@gr ncdr .
Kx tqvzbzkr kc nrlc sikapu txpwz mz bq r tewa .	kx tq @@vz @@bz @@kr kc nrlc sikapu txpwz mz bq r tewa .
Krlc merikol kx rblx nzmrbrtr-krde mz drtwrnge , murde nc teomo x nrla nc ninz da kx topwz , a' se tqmeitio mz katris .	krlc merikol kx rblx nz @@mrbr @@tr @@kr @@de mz drtwr @@nge , murde nc teomo x nrla nc ninz da kx topwz , a' se tq @@mei @@ti @@o mz katris .
Sc tqmcpex kx nqvi lr lemwzlo kxmrna esz'txu ngi krkc txpwz tqdolapx-ngrne mrkc wq .	sc tq @@mc @@pe @@x kx nqvi lr lemwzlo kx @@mrna esz'txu ngi krkc txpwz tq @@do @@la @@px @@ngr @@ne mrkc wq .
Xlrbzkr waelas ycmnepe mz nibr bz nyz kzu .	xlr @@bz @@kr waelas ycmne @@pe mz nibr bz nyz kzu .
Mz nzvz-krdr kc nzobq-moupqng mq , a' nc nzlu kc mrbrpe trtupeu mrkc .	mz nz @@vz @@kr @@dr kc nz @@obq @@mou @@mq @@ng mq , a' nc nzlu kc mrbr @@pe tr @@tu @@pe @@u mrkc .
Trtenge kalo lrpzu x lxenge pxi lrpzu .	trte @@nge kalo lrpzu x lxe @@nge pxi @@Ø lrpzu .
Drtwr ngrde nidr dalr nrlckxbq x nzdc-zvzng mz nrlckxbq .	drtwr ngr @@de nidr dalr nrlckxbq x nz @@dc @@zvz @@ngq mz nrlckxbq .
Pi-kzpo mz Daniel Boerger nzrtwzngr letz kcng tzrtctxngr mz alfabet ngr Natqgu .	pi @@kz @@bo mz Daniel Boerger nz @@rtwz @@ngr letz kcng tz @@rtctx @@ngr mz alfabet ngr Natqgu .
49 . Nzmncpe-krgr Tzngarare	49 . nz @@mnc @@pe @@kr @@gr Tzngarare
Mzli lc Dckta Foks kzdq Sade tqamukxtr Pawa x kzdq Sade Alankaulz .	mzli lc Dckta Foks kzdq Sade tq @@a @@mu @@kx @@tr Pawa x kzdq Sade Alankaulz .
Mqngr drka' kcng tqmctiamu mz ma kc tqtuom mz newz kc topwzne , drlzdr esz'ti , nzblqking amrlx .	mqngr drka' kcng tq @@mc @@ti @@amu mz ma kc tq @@tu @@o @@mq @@Ø mz newz kc topwzne , drlz @@dr esz' @@ti , nz @@blqki @@ng amrlx .
X nar ncboi kcma sc tqdotrbe elr .	x nar ncboi kcma sc tq @@do @@tr @@be elr .
X nwei' kx etu tqmwitxlzm elr .	x nwei' kx etu tq @@mwi @@tx @@lz @@mq elr .
Mnctikr mrlcde wiki li .	mnc @@ti @@kr mrlcde wiki li .
"Nzrpibzlr kx , "" Trgalr , a' ycpwz pipz nzbz-krgr .”"	"nz @@r @@pi @@bz kx , "" trgalr , a' ycpwz pipz nz @@bz @@kr @@gr .”"
Ayzlu-ngrbo natqde kx , “ Eu Mama , murde trau kc nzkam bange mz temz myaszpxle krkc nzkam bange mz skul mzli kc .”	a @@yzlu @@ngr @@bo natq @@de kx , “ eu mama , murde trau kc nz @@ka @@mq bange mz temz mya @@sz @@px @@le krkc nz @@ka @@mq bange mz skul mzli kc .”
Kx mcle nzvz-krnge sc tqkqlepebzle ninge .	kx mc @@le nz @@vz @@kr @@nge sc tq @@kqle @@pe @@bz @@le ninge .
Mzte nzmc mz mangrkxnzyagoxng Lwovz mz 20 Jun 1963 .	mz @@te nz @@mc mz manyzkxnzyagoxng Lwovz mz 20 Jun 1963 .
Kxetu ngr skul lc drtqde Alfred Hill .	kx @@etu ngr skul lc drtq @@de Alfred Hill .
04 . Nzrpilzngr Nigr Mz Lrlvz	04 . nz @@r @@pilz @@ngr nigr mz Lrlvz
Zbz sc tzveopebz pulis kcng x Ketea badr doa nedeng nigr mrkc Maluu .	zbz sc tz @@ve @@o @@pe @@bz pulis kcng x Ketea badr doa ne @@de @@ngq nigr mrkc Maluu .
"Rpibz Mama kx , "" Ninge Kxakrlz kx ngi nar skul x ni-kzpc' Mama ."""	"r @@pi @@bz mama kx , "" ninge kxakrlz kx ngi nar skul x ni @@kz @@mq @@x mama ."""
Mztea kx na-aelwati-ngrbz dalr trmctu , Mrnzq , Bznwz , Nrrle , Lvepx , Napr x Yc .	mztea kx na @@aelwa @@ti @@ngr @@bz dalr trmctu , Mrnzq , Bznwz , Nrrle , Lvepx , Napr x Yc .
Mz nzvecngr lcde yctxbz lcsu scdr lr Japan kxtrka .	mz nzvecngr lcde yc @@tx @@bz lcsu sc @@dr lr Japan kx @@trka .
Mz yiz 1955 vz-moux Nea mz nzrtangrtingr drtc' kzble kx naycngr skul kc Nemya' , murde Nemya' topwz x trpnzngr me napeti dakxnzng .	mz yiz 1955 vz @@mou @@x Nea mz nz @@rtangr @@ti @@ngr drtc' kzble kx na @@yc @@ngr skul kc Nemya' , murde Nemya' topwz x trpnzngr me na @@peti dakxnzng .
72 . Nzwzkr Nzrtekqtrngr Nzryrngrkxtr Krlzmle Sada Krus	72 . nz @@wz @@kr nz @@r @@tekqtr @@ngr nz @@r @@yr @@ngr @@kx @@tr krlz @@mq @@le Sada Krus
Nzvz-ngrmlr bange mz nzrlxti-krmlr kio kcng nzwrde tq .	nz @@vz @@ngr @@mq @@lr bange mz nz @@rlxti @@kr @@mq @@lr kio kcng nzwr @@de tq .
Vokr x prckr mz kzdq skul drtqde Alankaulz Skul .	vo @@kr x pr @@c @@kr mz kzdq skul drtq @@de Alankaulz Skul .
Zbz sc tqrpipemle kx natwzpex klas kcng li .	zbz sc tq @@r @@pi @@pe @@mq @@le kx na @@twz @@pe @@x klas kcng li .
"Sa naomimc mz nourla , bea x milzpq da kx nangqnamu ."""	"sa na @@o @@mi @@mq @@x mz nourla , bea x milzpq da kx na @@ngq @@amu ."""
"X rpimle kx , "" Nike tqrpi-ngrn eke ?"""	"x r @@pi @@mq @@le kx , "" nike tq @@r @@pi @@ngr @@n eke ?"""
Dckta amukxtrtx , yrkrpxbz x sc tzvzpeng mz Dikon Hill ma nyzde mz nzmu-krdr .	dckta a @@mu @@kx @@tr @@tx , yrkr @@px @@bz @@Ø x sc tz @@vz @@pe @@ng mz dikon Hill ma nyz @@de mz nz @@mu @@kr @@dr .
X mz Sade mz nourla nigr badr kc tqkrka'pekr mz makxtr nyzdr .	x mz Sade mz nourla nigr badr kc tq @@krka' @@pe @@kr mz makxtr nyz @@dr .
Ycmnetrpzkr , a' trayzlupxpleu natqgr .	ycmne @@tr @@bz @@kr , a' tr @@a @@yzlu @@px @@mq @@le @@u natq @@gr .
"Rpibzle kx , "" Nim dalr drlve ?"""	"r @@pi @@bz @@le kx , "" nim dalr drlve ?"""
76 . Rik Biukan Yzutr Nzyagox-krde	76 . Rik Biukan yzutr nz @@yagox @@kr @@de
Skul lc yctitxpwzle Naim yiz li x sc tzkatxpe mou .	skul lc yc @@ti @@tx @@pwz @@le Naim yiz li x sc tz @@katx @@pe mou .
A' yrlqtx-moux rtqlrdr , murde mzli kc tqvz-ngrne ma nyzgr mz nztwz-krnge neimr kio kcng , xlrx kc natq ycmnekimle mz nibrnge .	a' yrlq @@tx @@mou @@x r @@tq @@r @@dr , murde mzli kc tq @@vz @@ngr @@ne ma nyz @@gr mz nz @@twz @@kr @@nge neimr kio kcng , xlr @@x kc natq ycmne @@ki @@mq @@le mz nibr @@nge .
60 . Kosi Scdr Ncblo Kxnzakrlz X Nzalvztr-krnge Alankaula	60 . kosi sc @@dr ncblo kx @@nz @@a @@krlz x nz @@alvztr @@kr @@nge Alankaula
Kzdung mztea ma tunepwz li e tq , a' ma lcdeng tqtunepwz nzatolwa-ngrng mz nqvi kxkqlu .	kzdung mztea ma tu @@ne @@pwz li e tq , a' ma lcdeng tq @@tu @@ne @@pwz nz @@a @@tolwa @@ngr @@ngq mz nqvi kx @@kqlu .
Mqngr Ncbr drlzde prki , drtwr ngrde kx nide lr Bongavz , mrkc tqtingr nepi , x nzmncng mz Be Kxrpalz .	mqngr ncbr drlz @@de prki , drtwr ngr @@de kx nide lr bongavz , mrkc tq @@ti @@ngr nepi , x nz @@mnc @@ngq mz Be kxrpalz .
Nzmingr-krgr kc mz trlipu r tewa kc etu dwamitxtr-zpwxkr makxtr .	nz @@mingr @@kr @@gr kc mz trlipu r tewa kc etu dwami @@tx @@tr @@zpwx @@kr makxtr .
44 . Letz Ayrnr Kx Nzyrbz Mz Newz Tzlede	44 . letz ayrnr kx nz @@yr @@bz mz newz Tzlede
Tzsiu Jon rtangr x rmctile doa li , Andru Medrka' dalr Neboi x Samson Merlve dalr Mzjzbxlo .	tzsiu Jon rtangr @@Ø x r @@mc @@ti @@le doa li , Andru Medrka' dalr Neboi x Samson Merlve dalr Mzjzbxlo .
Rpim kxetu bagr navz dq nigr namcle kx ncblo kqlu mrkc e trtingr .	r @@pi @@mq kx @@etu bagr na @@vz @@Ø dq nigr na @@mc @@le kx ncblo kqlu mrkc e trtingr .
Mncx Mona Skul x doa negr krali kc mzte tzmcpe mz 9 Julae 1965 , drtqde Stanley Bade .	mnc @@x Mona Skul x doa ne @@gr kra @@li kc mz @@te tz @@mc @@pe mz 9 Julae 1965 , drtq @@de Stanley Bade .
Xlrbo kqlepele ninge .	xlr @@bo kqle @@pe @@le ninge .
A' pi-kzple kx mrlz drtwr Jon Lzpli naesz'ti-kzp mz drtwr lc .	a' pi @@kz @@mq @@le kx mrlz drtwr Jon Lzpli na @@esz'ti @@kz @@mq mz drtwr lc .
Ncblo kx rmale kc , sc tzpipebzlr mz tzsiu kcng li tqvznekr badr dzu r drta'dr .	ncblo kx r @@male kc , sc tz @@pi @@pe @@bz @@lr mz tzsiu kcng li tq @@vz @@ne @@kr badr dzu r drta' @@dr .
Mzli lcng tzmcngr mzkr , leplz sc tzpxyqbeng lrpzu .	mzli lcng tz @@mc @@ngr mz @@kr , leplz sc tz @@pxyq @@be @@ng lrpzu .
Kzdq zbq nzvzbzng sc tzxlropelr mz kzdq nzlc nzyrlekr lue .	kzdq zbq nz @@vz @@bz @@ng sc tz @@xlr @@o @@pe @@lr mz kzdq nzlc nz @@yrle @@kr lue .
Olvz lc kxmu-kzle lc .	olvz lc kxmu @@kz @@le lc .
33 . Dckta Fox Olvxtile Skul Mz Nzmc-krde Da Kx Nzatrkati Mz Nrlckxbq	33 . dckta Fox olvxti @@le skul mz nz @@mc @@kr @@de da kx nz @@a @@trka @@ti mz nrlckxbq
Takitr nabznepi kxesz' , xlrbzkr wisol krali yrni-ebirpeng kx lcsukxlvc kcngpe Luga narbompeng x mzli trboiu bom kcng tqyrputipxpe kz .	takitr nabz @@nepi kx @@esz' , xlr @@bz @@kr wisol kra @@li yrni @@ebir @@pe @@ngq kx lcsu @@kx @@lvc kcng @@pe Luga na @@r @@bom @@pe @@ngq x mzli tr @@boi @@u bom kcng tq @@yrpu @@ti @@px @@pe kz .
Mz nzavz-krmle zyagox , dzbi e nounenq , e tewa , e nzti-alokr nepi x kzdu kz da kzbleng .	mz nz @@a @@vz @@kr @@mq @@le zyagox , dzbi e nounenq , e tewa , e nz @@ti @@alo @@kr nepi x kzdu kz da kzble @@ngq .
Kio lcng trngiu kio ne skul ; krlcng kio nem pnatikr kau .”	kio lcng tr @@ngi @@Ø @@u kio ne skul ; krlcng kio ne @@mq pna @@ti @@kr kau .”
Kio kcng nzkalz-ngrmlrle pct nzwrde tq , a' mepyr ngrdr kc tqvobe .	kio kcng nz @@kapx @@lz @@ngr @@mq @@lr @@le pct nzwr @@de tq , a' mepyr ngr @@dr kc tq @@vo @@be .
X mz nzabzpx-krbzle natq kcng tztekqtrpeng mz doa lr mztea , Katkis mrkc Sen Tomas , Ben Mewz , aclvele nzwzngr lc , nidr mz Samwel Samwi , nidr badr Katkis mrkc Sen Pol , Leonard Menrlwz .	x mz nz @@abzpx @@kr @@bz @@le natq kcng tz @@tekqtr @@pe @@ngq mz doa lr mztea , katkis mrkc Sen Tomas , Ben Mewz , aclve @@le nz @@wz @@ngr lc , nidr mz Samwel Samwi , nidr badr katkis mrkc Sen Pol , Leonard Menrlwz .
Murde medesin amrlx nidr kcng tqtrkami lcsu Aijz .	murde medesin amrlx nidr kcng tq @@trka @@mi lcsu Aijz .
A' mz drtwrnge nrlade kxmrna .	a' mz drtwr @@nge nrla @@de kx @@mrna .
Mz nzrpi-krm kxnzetung mz nzvz-krnge mz skul kzble trpx-ngrneu x drtwrnge trvzkzu , a' mnc-abrtztxpo badr kxnzakrlz kztengeng .	mz nz @@rpi @@kr @@m kxnzetung mz nz @@vz @@kr @@nge mz skul kzble tr @@px @@ngr @@ne @@u x drtwr @@nge tr @@vz @@kz @@u , a' mnc @@abrtz @@tx @@bo badr kxnzakrlz kzte @@nge @@ngq .
Kx trmncne-zpwxpekru kc , sc tzycpengr drtwr lr Ncnqmz nigr .	kx tr @@mnc @@ne @@zpwx @@pe @@kr @@u kc , sc tz @@yc @@pe @@ngr drtwr lr Ncnqmz nigr .
X mou , nzrkzngr nzlu x nzrvingr nzlu murde narbingr x narpz'ngr kai , x na-akxlrngr loprta .	x mou , nz @@r @@kz @@ngr nzlu x nz @@r @@vi @@ngr nzlu murde na @@r @@bi @@ngr x na @@r @@pz' @@ngr kai , x na @@akxlr @@ngr loprta .
Skul lcde yc mz trmctu Nemya' x nzrpibz Nemya' Skul .	skul lcde yc mz trmctu Nemya' x nz @@r @@pi @@bz Nemya' skul .
Kx trwzpeleu kc , Aijz kc tqtwzpe nenq .	kx tr @@wz @@pe @@le @@u kc , Aijz kc tq @@twz @@pe nenq .
Nekeng nzpas mz klas rlimz nzatwzlrpwz Niu Silan , Austrelia e Inglan .	nekeng nz @@pas mz klas rlimz nz @@atwzlr @@pwz Niu Silan , Austrelia e Inglan .
Nzvzne-krgr lc trpnz'ngr scgr toki .	nz @@vz @@ne @@kr @@gr lc trpnzngr sc @@gr toki .
X tu kz mrlcde nc naq esz' x trdo-kzu .	x tu kz mrlcde nc naq esz' x tr @@do @@kz @@u .
Rpibz Kzpten kx drtwrde vztx , a' trrpwa'-ngrpwzleu ninge , murde kzdq la nzwzngr kx sutitx-zlwz drtwr leplz kx nzkqlu .	r @@pi @@bz kzpten kx drtwr @@de vz @@tx @@Ø , a' tr @@rpwa' @@ngr @@pwz @@le @@u ninge , murde kzdq la nz @@wz @@ngr kx suti @@tx @@zlwz drtwr leplz kx nz @@kqlu .
Da kx napitxtr-mopo mz da lcng li tzapulr merikol , da lcng aelwapx-pnz Gct mzli kc tqsiklube-ngrne mz yiz 1938 .	da kx na @@pi @@tx @@tr @@mou @@bo mz da lcng li tz @@apu @@lr merikol , da lcng aelwa @@px @@pnz Gct mzli kc tq @@siklu @@be @@ngr @@ne mz yiz 1938 .
74 . Nzalvztrngr Nigr	74 . nz @@alvztr @@ngr nigr
Dckrlzde Kc Nzlvqn	dckrlzde kc nzlvqn
Prcpelz kxwzle kc sc tqamqngitr-zlwzpele nqvi lr bot kc , x prcpelz sc trtqwzpeu .	prcpelz kx @@wz @@le kc sc tq @@a @@mqngi @@tr @@zlwz @@pe @@le nqvi lr bot kc , x prcpelz sc tr @@tq @@wz @@pe @@u .
Mz nrlckxbq sc tqvomitrpekr nqni mnrgr mz kampi x tqmwipekr elr .	mz nrlckxbq sc tq @@vo @@mi @@tr @@pe @@kr nqni mnr @@gr mz kampi x tq @@mwi @@pe @@kr elr .
Dckrlzde Kc Nzpnu-esz'-nrade-li	dckrlzde kc nzpnu @@esz' @@nra @@de @@li
Krlc merikol .	krlc merikol .
Zbz sc tqvzpebz mz Menabz , trte Lrlvz , kc tqvzne-zvzkr ncdr .	zbz sc tq @@vz @@pe @@bz @@Ø mz Menabz , trte Lrlvz , kc tq @@vz @@ne @@zvz @@kr ncdr .
Mama Tomson nide ncblo ngr nzwzngr kxetuting kcng tqalekr badr nide la tqrdatrpwz .	mama Tomson nide ncblo ngr nz @@wz @@ngr kx @@etu @@ti @@ngq kcng tq @@ale @@kr badr nide la tq @@rdatr @@pwz .
Murde nzmu drtwr Ncbr natrka-zlwzle x sc tqayzlupele bz scde , trkaku amrlx ngrgu mz nzayrplapx-krde nigu mz da kx na-avzmle .	murde nzmu drtwr ncbr na @@trka @@zlwz @@le x sc tq @@a @@yzlu @@pe @@le bz sc @@de , trka @@ku amrlx ngr @@gu mz nz @@ayrplapx @@kr @@de nigu mz da kx na @@a @@vz @@mq @@le .
Sekaentxkr badr x yrni-etrtxkr badr , x sc tzyapxpeng mz lcsu tzvopeng .	sekaen @@tx @@kr badr x yrni @@etr @@tx @@kr badr , x sc tz @@ya @@px @@pe @@ngq mz lcsu tz @@vo @@pe @@ngq .
"Rpibo kx , "" Tqyrkex murde nc nzlu kc tqyrplatrngr narm mrtupe ."""	"r @@pi @@bo kx , "" tq @@yrke @@x murde nc nzlu kc tq @@yrpla @@tr @@ngr nar @@mq mrtu @@pe ."""
X vea-mcpq bange , “ Trdwatrwamu mz naonrx lc ?”	x vea @@mou @@mq bange , “ tr @@dwa @@tr @@amu @@u mz naonrx lc ?”
Mz nzmu-krgr badr mz lrpzki mukr badr drta'dr , nzrpwa'-ngrmlr bange nzrtrngrtitr-krnge da kcng tqxpex tzmalebzlr .	mz nz @@mu @@kr @@gr badr mz lrpzki mu @@kr badr drta' @@dr , nz @@rpwa' @@ngr @@mq @@lr bange nz @@rtrngr @@ti @@tr @@kr @@nge da kcng tq @@xpe @@x tz @@male @@bz @@lr .
64 . Nzyrlz-krnge Krali	64 . nz @@yrlz @@kr @@nge kra @@li
"… A' ayrplapx ninge , murde nzvz-rbr-krdr tutrpq bange , mz trnzpi-krpou badr nzapxngr nzdwatrngr mz naonrx ngr rum kc tqtupx-ngrm mqngrm ."""	"… a' ayrplapx ninge , murde nz @@vz @@rbr @@kr @@dr tu @@tr @@mq @@Ø bange , mz tr @@nz @@pi @@kr @@bo @@u badr nz @@apx @@ngr nz @@dwa @@tr @@ngr mz naonrx ngr rum kc tq @@tu @@px @@ngr @@mq mqngr @@mq ."""
19 . Aijz Taglc Nrc Ngr Nenq Trlaki	19 . Aijz ta @@*glc nrc ngr nenq trlaki
Murde Boo yc-aepztr mz trloka kx yrlwrpx-ngrm mclrla kc tqayagoxle doa .	murde Boo yc @@aepz @@tr mz trloka kx yrlwr @@px @@ngr @@mq mclrla kc tq @@a @@yagox @@le doa .
Murde naokatr-lzbqgr badr trte x lxe doa mz nzaclvengr doa kxnztopwzng .	murde na @@okatr @@lzbq @@gr badr trte x lxe doa mz nz @@aclve @@ngr doa kx @@nz @@topwz @@ngq .
Nzvzmqng mz nzrtwz-krmlr Nrpakxmrlz bagr nigr leplz ngr Nea .	nz @@vz @@mq @@ng mz nz @@r @@twz @@kr @@mq @@lr Nrpakxmrlz bagr nigr leplz ngr Nea .
Nzamcti kz ncblo nzrlz-krbzle nedr mqngr drka ’, x nzamcti-kzlr nzrlz-krbzle nedr nelc .	nz @@amc @@ti kz ncblo nz @@r @@lz @@kr @@bz @@le ne @@dr mqngr drka' ’, x nz @@amc @@ti @@kz @@lr nz @@r @@lz @@kr @@bz @@le ne @@dr nelc .
Rpibo bade kx , “ Tryrnipewq mzli ka murde Jiszs sc tqmncpeku badr mz bot , delc dcpwe trtqdwaope-ngrdeu mz bot scgi .”	r @@pi @@bo bade kx , “ tr @@yrni @@pe @@q @@u mzli ka murde Jiszs sc tq @@mnc @@pe @@ku badr mz bot , delc dcpwe tr @@tq @@dwa @@o @@pe @@ngr @@de @@u mz bot sc @@gi .”
Ma lcng mztr mrbrtx alo .	ma lcng mz @@tr mrbr @@tx alo .
Mz nibrde rkqtxkr teomo yrlqtxtrkr mz bxki x nigr kc tqvzdzpekr mz Newz Tzlede .	mz nibr @@de rkq @@tx @@kr teomo yrlq @@tx @@tr @@kr mz bxki x nigr kc tq @@vz @@dz @@pe @@kr mz newz Tzlede .
Trnzsiklu-zpwx-krgru lc yrkrmitxpx yiz 1943 .	tr @@nz @@siklu @@zpwx @@kr @@gr @@u lc yrkr @@mi @@tx @@px yiz 1943 .
X kamle bange Nrpakxmrlz kc tqyr Mak .	x ka @@mq @@le bange Nrpakxmrlz kc tq @@yr Mak .
27 . Nzrlxti-krbz Tzsiu Jon Ninge Mz Trtenge Murde Na-atwzlr-ngrde Ninge Mz Skul	27 . nz @@rlxti @@kr @@bz tzsiu Jon ninge mz trte @@nge murde na @@atwzlr @@ngr @@de ni @@nge mz skul
Krlc merikol .	krlc merikol .
Da ayrnrngr kzdq nzrmangr mz nzyrlzngr .	da ayrnr kzdq nzrmangr mz nzyrlzngr .
Kxetu r skul lcde drtqde Mama Lesile Stibad dalr Inglan .	kxetu r skul lcde drtq @@de mama Lesile Stibad dalr Inglan .
Kzdq zbq kx nzmitin-ngrdr sc tzmcpxpelr kcng doa kx nangi nidr kxnzrtekqtr natq .	kzdq zbq kx nz @@mitin @@ngr @@dr sc tz @@mcpx @@pe @@lr kcng doa kx na @@ngi nidr kx @@nz @@r @@tekqtr natq .
Nrlc kxngrlxobzle mz Sade tewa kc tqdcpe .	nrlc kx @@ngrlx @@o @@bz @@le mz Sade tewa kc tq @@dc @@pe .
Veranaso Skul , nzrngisc-krde myaszpxle Pawa Skul , Alankaula Skul , Siota Skul x Bungana Skul .	Veranaaso skul , nz @@r @@ngi @@sc @@kr @@de mya @@sz @@px @@le Pawa skul , Alankaula skul , Siota skul x Bungana skul .
"Mz nzkrka'-krde rpile kx , "" Kxetu rgr Ncbr , aolvz blz kc tqkabzkr bam ."	"mz nz @@krka' @@kr @@de r @@pi @@le kx , "" kxetu r @@gr ncbr , aolvz blz kc tq @@ka @@bz @@kr bam ."
Krlzbzkr mrlcde nzawitxm bagr , x sc tzrkalzpem tzvzopeng prla x nigr kc tqvzdzpekr mz newz Tzlede .	krlz @@bz @@kr mrlcde nz @@awi @@tx @@mq bagr , x sc tz @@rkalz @@pe @@mq tz @@vz @@o @@pe @@ng prla x nigr kc tq @@vz @@dz @@pe @@kr mz newz Tzlede .
62 . Ncblo ngr Kwin Elisabet Vom Sada Krus	62 . ncblo ngr Kwin Elisabet vo @@mq Sada Krus
Zbz mz nrlckxbq lcde tzmwi-ngrdr mz Trmctu Nemya' , nenq trlaki sc tqwqpe .	zbz mz nrlckxbq lcde tz @@mwi @@ngr @@dr mz trmctu Nemya' , nenq trlaki sc tq @@wq @@pe @@Ø .
Zbz sc tqrpipem Rik bange kx navzne ncdr Gari Saemons mz nzlalztq-krde lc .	zbz sc tq @@r @@pi @@pe @@mq Rik bange kx na @@vz @@ne ncdr Gari Saemons mz nz @@lalztq @@kr @@de lc .
X tqmctipekr mqngr drka' kxkqlu .	x tq @@mc @@ti @@pe @@kr mqngr drka' kx @@kqlu .
Kx xlrbzle nzvzkr drtwrdr nzpnati-krbzlr kio nede , sc tqrpipebzle badr kx , “ Ipqpebo nimu mz nzplzpx-krmamu bange nzpnati-krbzmu kio nenge .	kx xlr @@bz @@le nz @@vz @@kr drtwr @@dr nz @@pna @@ti @@kr @@bz @@lr kio ne @@de , sc tq @@r @@pi @@pe @@bz @@le badr kx , “ ipq @@pe @@bo nimu mz nz @@plzpx @@kr @@mq @@mu bange nz @@pna @@ti @@kr @@bz @@mu kio ne @@nge .
Mz nzalvztr-krnge mz skul , yiz kcng tqayzutr-ngrne tq , 1950 , 1951 , x 1952 tr-rtwzwxu trau elr .	mz nz @@alvztr @@kr @@nge mz skul , yiz kcng tq @@ayzutr @@ngr @@ne tq , 1950 , 1951 , x 1952 tr @@r @@twz @@x @@u trau elr .
X yrkrpxx mz skul mz yiz 1948 .	x yrkr @@px @@x mz skul mz yiz 1948 .
Dwatrpzkr , sc tqrpipebo mz mqngr drka' kc kx , “ Myx toki scm ?	dwa @@tr @@bz @@kr , sc tq @@r @@pi @@pe @@bo mz mqngr drka' kc kx , “ myx toki sc @@mq ?
16 . Dxvo Kxetu	16 . dxvo kx @@etu
Yzlumc , otitxne pct scgr kxetu , pawitxne nc kc ncte pwx , x tqkukipe-ngrne .	yzlu @@mq @@x , oti @@tx @@ne pct sc @@gr kx @@etu , pawi @@tx @@ne nc kc nctq @@de pwx , x tq @@kuki @@pe @@ngr @@ne .
Yrlztix olvz lr Pa'lz drtqde Ellen Itopwz , mz yiz 1962 .	yrlz @@ti @@x olvz lr Pa'lz drtq @@de Ellen Itopwz , mz yiz 1962 .
Ma kcng nzsiklungr doa kxnztopwz bxplitipe x ma nyz kxakrlz dcplxtipe kz .	ma kcng nz @@siklu @@ngr doa kx @@nz @@topwz bxpli @@ti @@pe x ma nyz kxakrlz dc @@*plx @@ti @@pe kz .
Kzdq nrlckxbq dwa-rbrlz-ngrmgr nzveckr lcsu mz mzli kc Savo .	kzdq nrlckxbq dwalzm @@rbr @@lz @@ngr @@mq @@gr nz @@vec @@kr lcsu mz mzli kc Savo .
Kx mctrpzle kc mqngr Ncbr , sc tqrpipemle bange kx , “ Kzdq la ncblo kxprki tqwxbupxm mrla brma .”	kx mc @@tr @@pz @@le kc mqngr ncbr , sc tq @@r @@pi @@pe @@mq @@le bange kx , “ kzdq la ncblo kx @@prki tq @@wxbu @@px @@mq @@Ø mrla brma .”
"Rpibzle kx , Ninge dalr Inglan ."""	"r @@pi @@bz @@le kx , ninge dalr Inglan ."""
Mzli lcde nide Josip sc tqngi presiden ngr trmctu ka .	mzli lcde nide Josip sc tq @@ngi presiden ngr trmctu ka .
Drvrminemle taol li kx na-amingr-ngrgr drtqgr .	drvr @@mi @@ne @@mq @@le taol li kx na @@amingr @@ngr @@gr drtq @@gr .
Rpix kx , “ Jiszs , okatrpq ninge .”	r @@pi @@x kx , “ Jiszs , okatr @@mq ninge .”
Ayzlu-ngrbo natqde kx trpnzngr kio kx twzx , a' kapxmc neimr kio tq .	a @@yzlu @@ngr @@bo natq @@de kx trpnzngr kio kx twz @@x , a' kapx @@mq @@x neimr kio tq .
Dwalzmgr mz nourla mz zbq kx nzopx-ngrm , bqtc ngr nanyc Daniel nzpnutitx x nzlxplztx kz x sc tqvzpekr badr pulis kc tqotimle nigr .	dwalzm @@mq @@gr mz nourla mz zbq kx nz @@opx @@ngr @@mq , bqtc ngr nanyc Daniel nz @@pnuti @@tx x nz @@lxplz @@tx kz x sc tq @@vz @@pe @@kr badr pulis kc tq @@oti @@mq @@le nigr .
Nzmcpx-kzlr kzbznyon ninge mz nzngini-krnge kxetu kzdq dzbe kzbznyon ngr Ol Sens .	nz @@mcpx @@kz @@lr kzbznyon ninge mz nz @@ngini @@kr @@nge kx @@etu kzdq dzbe kzbznyon ngr Ol Sens .
"Rpi-mopwz kxetu kc kx , "" Nzycmnengr la tryrplatitrpwzu narnge , yapwxti-zpwxmamu ena ."""	"rpi @@mou @@bz kx @@etu kc kx , "" nzycmnengr la tr @@yrplati @@tr @@pz @@u nar @@nge , yapwx @@ti @@zpwx @@mq @@amu ena ."""
Zbz kzdung nigr sc tzmnctxpeng badr Mama Wili , x kzdung nzsutipe drtwrdr nzvzngr .	zbz kzdung nigr sc tz @@mnc @@tx @@pe @@ng badr mama Wili , x kzdung nz @@suti @@pe drtwr @@dr nz @@vz @@ngr .
Mz nibrde ninge tqasiklu ate doa kxnztopwzng .	mz nibr @@de ninge tq @@a @@siklu ate @@Ø doa kx @@nz @@topwz @@ngq .
Sc tzyapwxtipebzlr kxmu nzrmcti-krdr lr Japan x kxmu nzarlapxkr Gct nidr mz ncu kros kc .	sc tz @@yapwx @@ti @@pe @@bz @@lr kxmu nz @@rmcti @@kr @@dr lr Japan x kxmu nz @@arlapx @@kr Gct nidr mz ncu kros kc .
Kx vztr-mcpc' kc mz nc bia kc sc tqlolvzpe-moux , x ninge kc tqvolzpe-moux .	kx vz @@tr @@mou @@mq @@x kc mz nc bia kc sc tq @@lolvz @@pe @@mou @@x , x ninge kc tq @@vo @@lz @@pe @@mou @@x .
Joseph Menaip , nidr badr Sophia Jane Ivaio x Elizabeth Ilovz , nzprtrng badr katkis lcng nztqng mz nzapqtr-krbzlr drtwr lr makxtr mz nzrlwx-krdr Natq Gct mz Natqgu .	joseph Menaip , nidr badr Sophia Jane Ivaio x Elizabeth Ilovz , nz @@prtr @@ng badr katkis lcng nz @@tq @@ngq mz nz @@apqtr @@kr @@bz @@lr drtwr lr makxtr mz nz @@rlwx @@kr @@dr natq Gct mz Natqgu .
Kxetu kc tqmnctxpwzkr badr nide mama , x drtqde Mama Wili Parapolo , dalr Gela .	kxetu kc tq @@mnc @@tx @@pwz @@kr badr nide mama , x drtq @@de mama Wili Parapolo , dalr Gela .
Mz nibr nzmqlrpi-krnge trtenge sc tqdwatrpe mz rum kc tqwxbupx-ngrm mgngr Ncbr .	mz nibr nz @@mqlrpi @@kr @@nge trte @@nge sc tq @@dwa @@tr @@pe mz rum kc tq @@wxbu @@px @@ngr @@mq mqngr ncbr .
Kx mwelr-zlwzkr , sc tqrpipem Kxetu r skul nadwapekr badr peto .	kx mwelr @@zlwz @@kr , sc tq @@r @@pi @@pe @@mq kxetu r skul na @@dwa @@pe @@kr badr peto .
A' rpi-mcpq kxetu kc kx trsutiu drtwrde doa kx pwx , murde naesz'mzng x doa kcng napipx-lzbqng naesz'mz kz .	a' rpi @@mou @@mq kx @@etu kc kx tr @@suti @@u drtwr @@de doa kx pwx , murde na @@esz'mz @@ng x doa kcng na @@pipx @@lzbq @@ng na @@esz'mz kz .
Alvztr-ngrne yiz nzpnu-li-nrade-li .	alvztr @@ngr @@ne yiz nzpnu @@li @@nra @@de @@li .
Dckrlzde Kc Rtqmz	dckrlzde kc rtqmz
X nzmu namrbrtitr drtwr nzrlxkqtiongr nar letz lcdeng , nzycmnengr kc tqtrkape .	x nzmu na @@mrbr @@ti @@tr drtwr nz @@r @@lxkqti @@o @@ngr nar letz lcdeng , nz @@ycmne @@ngr kc tq @@trka @@pe .
Mzli kc bqnc trmctu ka yrbu mz leplz murde nzangio-txpwzlr Be ncdr Ncbr x nzmnclzbz badr mz nivz lrdr , x nzrmctilr da amrlx trrblxpwzu badr .	mzli kc bqnc trmctu ka yrbu mz leplz murde nz @@angio @@tx @@pwz @@lr Be ncdr ncbr x nz @@mnc @@lz @@bz badr mz nivz lr @@dr , x nz @@rmcti @@lr da amrlx tr @@rblx @@pwz @@u badr .
Vzbo sc tqrpipemle bange kx , “ Neke ryzkr tabao mrlc ?”	vz @@bo sc tq @@r @@pi @@pe @@mq @@le bange kx , “ neke r @@yzkr tabao mrlc ?”
Kzdq kc zbq , kzdq lrmztangi ngr Lipz Kzbzni kx aclvele Lapuro , drtqde Mr Atq , ryrm letz mz kxetu rgr kx mncpwzkr badr .	kzdq kc zbq , kzdq lrmztangi ngr Lipz Kzbzni kx aclve @@le Lapuro , drtq @@de Mr Atq , r @@yr @@mq letz mz kx @@etu r @@gr kx mnc @@pwz @@kr badr .
Mzli kc milzpq Mama vzm sc tqyapwxtipemle bagr lcsu kc x da kc tqotimle .	mzli kc milzpq mama vz @@mq @@Ø sc tq @@yapwx @@ti @@pe @@mq @@le bagr lcsu kc x da kc tq @@oti @@mq @@le .
Da kxmule lcde navzngr drtwr x nakabz bade blz , x sc tqayzlu-atele bz scde .	da kx @@mu @@le lcde na @@vz @@ngr drtwr x na @@ka @@bz ba @@de blz , x sc tq @@a @@yzlu @@ate @@le bz sc @@de .
Nzpibzlr badr mz nrlckxbqpe mz nabz nepi kc tqrtqmz .	nz @@pi @@bz @@lr badr mz nrlckxbq @@pe mz nabz nepi kc tq @@rtqmz .
75 . Rik Rkam Nzwzngr Bagr	75 . Rik r @@ka @@mq nz @@wz @@ngr bagr
Mz nzwzkr dckta , tqrlxplz leplz , tqrpnu'ti kxsqki x tqrkabz medesin badr kxnzyagoxng .	mz nz @@wz @@kr dckta , tq @@r @@lxplz leplz , tq @@r @@pnu'ti kxsqki x tq @@r @@ka @@bz medesin badr kx @@nz @@yagox @@ngq .
Mrlz , sc tqvzpe mou mz nzolvxti-krde nrlc , rmnr-ngrtxbzle ma kx wxbupx-ngrm enjin ngr gas .	mrlz , sc tq @@vz @@pe mou mz nz @@olvxti @@kr @@de nrlc , rmnr @@ngr @@tx @@bz @@le ma kx wxbu @@px @@ngr @@mq enjin ngr gas .
Kx yrkrpxx kc mz skul , sc tqpipebo mz kxetu ngr skul krali drtqde Mama Roklip dalr Inglan .	kx yrkr @@px @@x kc mz skul , sc tq @@pi @@pe @@bo mz kx @@etu ngr skul kra @@li drtq @@de mama Roklip dalr Inglan .
Awitxbo mz kxetu x ninge kc tqrke-atex bia .	awi @@tx @@bo mz kxetu x ninge kc tq @@rke @@ate @@x bia .
Mzli kc tqyrkrpengr raes , bisket x tin ngr poi nagr x trpengr da kx nangqkr .	mzli kc tq @@yrkr @@pe @@ngr raes , bisket x tin ngr poi na @@gr x trpengr da kx na @@ngq @@kr .
Nzaglq-krbzkr dztudr ami mz kampi scdr zbq li mz wiki kxesz' .	nz @@a @@glq @@kr @@bz @@kr dztu @@dr ami mz kampi sc @@dr zbq li mz wiki kx @@esz' .
Zbz Saotzn Kros kx vomle kc mz yiz 1937 , nigr rtqlrgr kc tqvopekr elr .	zbz Saotzn Kros kx vo @@mq @@le kc mz yiz 1937 , nigr r @@tq @@r @@gr kc tq @@vo @@pe @@kr elr .
A' trtenge tutxpwz x sc tqkrka'pe .	a' trte @@nge tu @@tx @@pwz x sc tq @@krka' @@pe @@Ø .
Aveati-zvzmle ninge mz ma nyzde , x inyxdeng nzleka-zvzmlr ninge Paumalepc .	aveati @@zvz @@mq @@le ninge mz ma nyz @@de , x inyx @@de @@ngq nz @@leka @@zvz @@mq @@lr ninge Paumalepc .
A' napitxpo ye nzabzokr nzkrka' krde x mrkc tqyrkrkipxle .	a' na @@pi @@tx @@bz @@o ye nz @@abzo @@kr nzkrka' kr @@de x mrkc tq @@yrkr @@ki @@px @@le .
Leplz ngr trmctu ka , Utupua , Vanikoro , Tikopia , Anuta , Nzlvz , Dapq x Pileni nzyrkrmqng mrka Gresosa Bei .	leplz ngr trmctu ka , Utupua , Vanikoro , Tikopia , Anuta , Nzlvz , Dapq x Pileni nz @@yrkr @@mq @@ng mrka Gresosa Bei .
Nzmcpe-kzpz kxnzmnztrng , a' trpnzngrpwz .	nz @@mc @@pe @@kz @@pz kxnzmnztrng , a' trpnzngr @@pwz .
Mz nzayonepe-krdr mz vea-kapq mz nzrnibq-krdr leplz , delc tqamznrpele mztea kxkqlu ngr trmctu ka .	mz nz @@ayo @@ne @@pe @@kr @@dr mz vea @@kapq mz nz @@r @@nibq @@kr @@dr leplz , delc tq @@a @@mznr @@pe @@le mztea kx @@kqlu ngr trmctu ka .
Kx rblxtxpele kc sc tztulrtrpem doa kx nzkqlu bange kx nangininge doa kraesz'mz .	kx rblx @@tx @@pe @@le kc sc tz @@tulr @@tr @@pe @@mq doa kx nz @@kqlu bange kx na @@ngini @@nge doa kraesz'mz .
Mztr nzmc mz mzlir yiz kcng 1800 x nzbzng mz mzlir yiz kcng 1900 .	mz @@tr nz @@mc mz mzlir yiz kcng 1800 x nz @@bz @@ng mz mzlir yiz kcng 1900 .
Olzbo mrkcpe wq , sc tqtatipe mqnge kxrtc kc kzdq nrla nc bia kxglr .	olz @@bo mrkc @@pe wq , sc tq @@ta @@ti @@pe mq @@nge kx @@rtc kc kzdq nrla nc bia kx @@glr .
Mz nzngi-trpengrkr nounc kx tuti , utc ngr peto nzbzti-lxblrng murde trpengr nra nounc kx nangqdr .	mz nz @@ngi @@trpengr @@kr nounc kx tu @@ti , utc ngr peto nz @@bz @@ti @@lxblr @@ngq murde trpengr nra nounc kx na @@ngq @@dr .
Mz nibr nounenq lcde kc tzmctxpwz nzlalatikr nounc x nzpctikr leu rdr mz nzglrpe-krdr .	mz nibr nounenq lcde kc tz @@mc @@txpwz nz @@lala @@ti @@kr nounc x nz @@pc @@ti @@kr leu r @@dr mz nz @@glr @@pe @@kr @@dr .
Mnctiomgr mz newz kc temz tq x dakxnzng nagr sc tqyrkrpe .	mnc @@ti @@o @@mq @@gr mz newz kc temz tq x dakxnzng na @@gr sc tq @@yrkr @@pe .
Yzlumc , sc tqrpimle kx naobqlvzti-zpwxx mrkc x napinemc kx ncblo tqlvr kx mnc mrkc .	yzlu @@mq @@x , sc tq @@r @@pi @@mq @@le kx na @@obq @@lvz @@ti @@zpwx @@x mrkc x na @@pi @@ne @@mq @@x kx ncblo tqlvr kx mnc mrkc .
Krlcng da kx rblx nzmrbrtr-krdr mz drtwr .	krlcng da kx rblx nz @@mrbr @@tr @@kr @@dr mz drtwr .
"Rpi-moupqle kx , "" Trnanibqleu nim nadq kc , a' nabz-ngrn katris ."""	"rpi @@mou @@mq @@le kx , "" tr @@na @@nibq @@le @@u nim nadq kc , a' na @@bz @@ngr @@nq katris ."""
Rblx murde yc mz Natqgu vaol nzpnu esz' .	rblx murde yc mz Natqgu vaol nzpnu esz' .
Yzlumc Sada Krus mz temz Mas mz yiz 1958 .	yzlu @@mq @@x Sada Krus mz temz Mas mz yiz 1958 .
Mz yiz lcpwz 1928 mztea nyzgr Mzdxmingr sc tqmznrpe .	mz yiz lcpwz 1928 mztea nyz @@gr Mzdxmingr sc tq @@mznr @@pe @@Ø .
X mzli lcdepwz kzdq doa lr Nea sc tqkaputrpe-kzpz , sc tzveatipebzlr bade .	x mzli lcde @@pwz kzdq doa lr Nea sc tq @@kaputr @@pe @@kz @@pz , sc tz @@vea @@ti @@pe @@bz @@lr bade .
Zbz sc tqmupekr badr mzli kc milzpq .	zbz sc tq @@mu @@pe @@kr badr mzli kc milzpq .
Nzvo-krgr kc abrtztxpekr , da kc tqwai nzabrtz-krgr Tzngarare sc tqvztx alo .	nz @@vo @@kr @@gr kc abrtz @@tx @@pe @@kr , da kc tq @@wai nz @@abrtz @@kr @@gr Tzngarare sc tq @@vz @@tx alo .
Ninge , tulzmc mz nrlckxbq lcde , ninge kc tqvzpex mz nabxbz ngr kio ne Dckta Fox kc tqaclvex , murde ma tztavetr-kzlr naonrx ngrde x tzrtwz-kzng kio .	ninge , tu @@lz @@mq @@o mz nrlckxbq lcde , ninge kc tq @@vz @@pe @@x mz nabxbz ngr kio ne dckta Fox kc tq @@aclve @@x , murde ma tz @@tave @@tr @@kz @@lr naonrx ngr @@de x tz @@r @@twz @@kz @@ng kio .
Kzdq zbq kx yagox-kzngr Ellen , rpimle bange mz nrlckxbqpe nangelubo nade nrtq .	kzdq zbq kx yagox @@kz @@ngr Ellen , r @@pi @@mq @@le bange mz nrlckxbq @@pe na @@ngelu @@bo na @@de nrtq .
Vomc Boo skul mz Saotzn Kros 7 mz temz Jenwzri 1950 .	vo @@mq @@o Boo skul mz Saotzn Kros 7 mz temz Jenwzri 1950 .
Mnctxpwzkr mz natq kxetu rgr .	mnc @@tx @@pwz @@kr mz natq kx @@etu r @@gr .
X mzli kcpwz pipz opx mz mzke' kc ncblo apule mama .	x mzli kcpwz pipz opx mz mz @@ke' kc ncblo apu @@le mama .
Drtq Mzdealwx kx nzyrlqbz tzsiu Tomas , murde rpile namc-kaile dakc nalxngitile , x trtenge drtqde Fredrik murde rpile nakrlz-kaile drtwr ngr da kx nalxngitile .	drtq Mzdealwx kx nz @@yrlq @@bz tzsiu Tomas , murde r @@pi @@le na @@mc @@kai @@le da @@kc na @@lxngiti @@le , x trte @@nge drtq @@de Fredrik murde r @@pi @@le na @@krlz @@kai @@le drtwr ngr da kx na @@lxngiti @@le .
A' trkrlzkru rlilrgr nzngikr ma ngr mqngr drka' le .	a' tr @@krlz @@kr @@u r @@li @@r @@gr nz @@ngi @@kr ma ngr mqngr drka' le .
Kxetu rdr vzm rpimle bagr mrlz nzvz-krbzkr mz mzlir leplz nedeng .	kx @@etu r @@dr vz @@mq @@Ø r @@pi @@mq @@le ba @@gr mrlz nz @@vz @@kr @@bz @@kr mz mzlir leplz ne @@de @@ngq .
Nzvzbzng x kxetu r ami kcng sc tqveapebz mz Mama Lesile .	nz @@vz @@bz @@ng x kxetu r ami kcng sc tq @@vea @@pe @@bz mz mama Lesile .
Zbz mz temz Aogzs kzdq doa lr Sikaiana yagoxtx .	zbz mz temz Aogzs kzdq doa lr Sikaiana yagox @@tx .
Natqgu ngi kzdq natq kx rblx-esz'ngr nzryrngr .	Natqgu ngi kzdq natq kx rblx @@esz'ngr nzryrngr .
Daniel Boerger kc natekqtrle Rik krlzmle Sada Krus mz yiz 1988 .	Daniel Boerger kc na @@tekqtr @@le Rik krlz @@mq @@le Sada Krus mz yiz 1988 .
Mz nibrde sc tzwrkxtrpeng rlilrdr .	mz nibr @@de sc tz @@wrkxtr @@pe @@ngq r @@li @@r @@dr .
Sc tqrpipebzle badr , “ Nc la bztipede nzyrle-krde , ma tqwxlikitxpx , kaomamu , namupeku .”	sc tq @@r @@pi @@pe @@bz @@le badr , “ nc la bz @@ti @@pe @@de nz @@yrle @@kr @@de , ma tq @@wxliki @@tx @@px , kapx @@o @@mq @@amu , na @@mu @@pe @@ku .”
Rpibz Gari Saemons mz Rik kx trmctu ka takitrtxpwzle natq li kx natekqtrngr Nzryrngrkxtr .	r @@pi @@bz Gari Saemons mz Rik kx trmctu ka takitr @@tx @@pwz @@le natq li kx na @@tekqtr @@ngr Nzryrngrkxtr .
Kam , naryakr-ngrgr noli mqgr .”	ka @@mq , na @@r @@yzkr @@ngr @@gr noli mq @@gr .”
Ncblo kcma yzlum sc tqpipebzle badr lr mztea nyzde .	ncblo kcma yzlu @@mq sc tq @@pi @@pe @@bz @@le badr lr mztea nyz @@de .
"Rpimle bange kx , "" Mclq doa kcng nztavelr naonrx lc ?"""	"r @@pi @@mq @@le bange kx , "" mc @@q doa kcng nz @@tave @@lr naonrx lc ?"""
Zbz Pasto Frank Yrpusz tu-lxblrkr badr abzo mz yiz 1993 krlzmle 2006 .	zbz pasto Frank Yrpusz tu @@lxblr @@kr badr abzo mz yiz 1993 krlz @@mq @@le 2006 .
Kx mc Mcnika nzdwao-krnge prla sc tqyrninepe-kzpq mule nzdwaope-kzpq , a' rpwa'-ngrbo .	kx mc Mcnika nz @@dwa @@o @@kr @@nge prla sc tq @@yrni @@ne @@pe @@kz @@mq mu @@le nz @@dwa @@o @@pe @@kz @@mq , a' rpwa' @@ngr @@bo .
Nzabrtzngr mz skul lc myaszpxle Alankaula Skul .	nz @@abrtz @@ngr mz skul lc mya @@sz @@px @@le Alankaula skul .
Vzbzkr mz kzdq nrlc rmctipekr kc dzbe leplz , rpim kxetu rdr bagr kx navzkr ye sa tqmrlz .	vz @@bz @@kr mz kzdq nrlc rmcti @@pe @@kr kc dzbe leplz , r @@pi @@mq kx @@etu r @@dr bagr kx na @@vz @@kr ye sa tq @@mrlz .
Mz nzvzne-krdr lc , kzdu nrlc nzrmctilr me nzvzkilr Mama Lesile , nzma-nqblqlr x tqmrbr mou .	mz nz @@vzne @@kr @@dr lc , kzdu nrlc nz @@rmcti @@lr me nz @@vz @@ki @@lr mama Lesile , nz @@ma @@nqblq @@lr x tq @@mrbr mou .
Nzdwatxcng amrlx ngrdr .	nz @@dwa @@tx @@c @@ng amrlx ngr @@dr .
Tzsiu lcng li nzalvztrlr kzdq dzbe doa Lea kx nawrkxtr-kaing x ninge prtrx mz dzbede lcde nawrkxtr kai .	tzsiu lcng li nz @@alvztr @@lr kzdq dzbe doa lr @@Nea kx na @@wrkxtr @@kai @@ngq x ninge prtr @@x mz dzbede lcde na @@wrkxtr @@Ø kai .
Rpibo bade kx naonrx ngr nabxbz lc nztavetr x kio lcng mrbrpxm tq .	r @@pi @@bo bade kx naonrx ngr nabxbz lc nz @@tave @@tr x kio lcng mrbrpxm tq .
Nzobqpxbz mz nctq newz kc tzvzkipxlr kzdq la nc nzlu tqtutrpq elr .	nz @@obq @@px @@bz mz nctq newz kc tz @@vz @@ki @@px @@lr kzdq la nc nzlu tq @@tu @@tr @@mq elr .
Wztitxpo mz Saotzn Kros 7 yiz esz'txu 1949 .	wz @@ti @@tx @@bz @@o mz Saotzn Kros 7 yiz esz'txu 1949 .
Vz kai mz stoa , x sc tqolvxti-atele ma kcng tzmwipx-ngrm doa kxnzsiklu x ma kcng tzsiklupx-ngrmlr .	vz kai mz stoa , x sc tq @@olvxti @@ate @@le ma kcng tz @@mwi @@px @@ngr @@mq doa kx @@nz @@siklu x ma kcng tz @@siklu @@px @@ngr @@mq @@lr .
Sc tqrpipemle bange kx drtwrde suti nzmungr banyapu o ckrle mz natq lr Nea .	sc tq @@r @@pi @@pe @@mq @@le bange kx drtwr @@de suti nz @@mu @@ngr banyapu o ckrle mz natq lr Nea .
Mz yiz lcpwz sc tqxlrpekr nrpa ngr vea kc tzpnz-lzbqngr lr Inglan badr lr Jzmzne .	mz yiz lcpwz sc tq @@xlr @@pe @@kr nrpa ngr vea kc tz @@pnz @@lzbq @@ngr lr Inglan badr lr Jzmzne .
Kx nzmnclr kc Bznwz sc tqablzo-atele nzwz-krgr badr .	kx nz @@mnc @@lr kc Bznwz sc tq @@ablzo @@ate @@le nz @@wz @@kr @@gr badr .
Nzpipx-lzbq-kaing doa nzpwxng .	nz @@pipx @@lzbq @@kai @@ng doa nz @@pwx @@ngq .
Nzabrtztx-zlwzngr Kxetu r skul kc , nidr badr doa nedeng nzvz-krbzkr .	nz @@abrtz @@tx @@zlwz @@ngr kxetu r skul kc , nidr badr doa ne @@de @@ngq nz @@vz @@kr @@bz @@kr .
Nzdwa-rbrlz-ngrm Kzpten badr kru nedeng Aijz nzalxngitikr ebio le mzli kc mz rngalx .	nz @@dwalzm @@rbr @@lz @@ngr @@mq kzpten badr kru ne @@de @@ngq Aijz nz @@a @@lxngi @@ti @@kr ebio le mzli kc mz rngalx .
Mz nzrtekqtrngr Natq Gct , Mathias Oti prtrp bagr mz yiz 1989 krlzmle 1991 .	mz nz @@r @@tekqtr @@ngr natq Gct , Mathias Oti pr @@tr @@mq bagr mz yiz 1989 krlz @@mq @@le 1991 .
Mutr-ngrgr mz nc nzlu kcng esz'mz x nc naq kc esz' temz li x ncte kc .	mu @@tr @@ngr @@gr mz nc nzlu kcng esz'mz x nc naq kc esz' temz li x nctq @@de kc .
Doa li nzmcpxlr , kzdq drtqde Stipin Srpi , doa lr Mzlo , x kzdq ninge doa lr Nea .	doa li nz @@mc @@px @@lr , kzdq drtq @@de Stipin Srpi , doa lr Mzlo , x kzdq ninge doa lr Nea .
15 . Nzmncpe-krgr Bokapwr	15 . nz @@mnc @@pe @@kr @@gr Bokapwr
50 . Lcsu Kc Tqvongrgr Nzpnz' Tenaru	50 . lcsu kc tq @@vo @@ngr @@gr nz @@pnz' Tenaru
07 . Nrzkakrbz Trtenge Blz Mz Ncbr X Nzkrka'krbzle Nigr Mz Lrlvz Bade	07 . nz @@r @@ka @@kr @@bz trte @@nge blz mz ncbr x nz @@krka' @@kr @@bz @@le nigr mz Lrlvz bade
Zbz mzli kc tzmupe-ngrdr , kzdq doa kcng nzpwxng nzpnatilr kio kcng , sc tqrpipebzle mz Dckta Fox kx , “ Drtwrgr vztxpe-ngrde nzpnati-krgr nim kqlutxpe .	zbz mzli kc tz @@mu @@pe @@ngr @@dr , kzdq doa kcng nz @@pwx @@ngq nz @@pna @@ti @@lr kio kcng , sc tq @@r @@pi @@pe @@bz @@le mz dckta Fox kx , “ drtwr @@gr vz @@tx @@pe @@ngr @@de nz @@pna @@ti @@kr @@gr nim kqlu @@tx @@pe .
Doa lc aclvebzle waelas mz lcsu .	doa lc aclve @@bz @@le waelas mz lcsu .
38 . Merikol Ayrnrngr Mz Mzli R Vea	38 . merikol ayrnr mz mzli r vea
"Rpiobzle badr kx , "" Nike tqkuki-ngrnamu ?"""	"r @@pi @@o @@bz @@le badr kx , "" nike tq @@kuki @@ngr @@amu ?"""
"Yzlu x yrlqtx mou neimr kio lang ."""	"yzlu x yrlq @@tx mou neimr kio la @@ngq ."""
Sc tqlvc-nqblq-moule ncte kc tqdotr mz nqvi lr lika kc .	sc tq @@lvc @@nqblq @@mou @@le nctq @@de kc tq @@do @@tr mz nqvi lr lika kc .
Abzokr Mztq sc tqvzkilzpekr kc krlzbzkr Ncokz .	abzo @@kr Mztq sc tq @@vz @@ki @@lz @@pe @@kr kc krlz @@bz @@kr Ncokz .
Dckrlzde Kc Nzpnu-esz'-nrade-pwx	dckrlzde kc nzpnu @@esz' @@nra @@de @@pwx
Nounenq lcde odatitx-atwrnz-ngrde mrka Sada Krus .	nounenq lcde oda @@ti @@tx @@atwrnr @@ngr @@de mrka Sada Krus .
Da kcng tqrglqtikr dakxnzng , biz mqdr , pu , katris , bom kxtopwzting , toki r vea , lrpz , hat , but , x taea ngr trak .	da kcng tq @@r @@glq @@ti @@kr dakxnzng , biz mq @@dr , pu , katris , bom kx @@topwz @@ti @@ngq , toki r vea , lrpz , hat , but , x taea ngr trak .
Zbz tzsiu Jon sc tqkrka'pebz .	zbz tzsiu Jon sc tq @@krka' @@pe @@bz @@Ø .
A' Kzpten px-ngrde nzdwaongr mz bot , rpile nabzmipele lcsu scde .	a' kzpten px @@ngr @@de nz @@dwa @@o @@ngr mz bot , r @@pi @@le na @@bz @@mi @@pe @@le lcsu sc @@de .
X nzmq lcglz kxetu tu kz mrlcde kc tqwz-ngrgr ma .	x nzmq lcglz kx @@etu tu kz mrlcde kc tq @@wz @@ngr @@gr ma .
Rpibo bade , mz nabz tewa kc ngi merikol , murde trlrprkru mz nzvz-krmgr kc mz tewa kc etu .	r @@pi @@bo bade , mz nabz tewa kc ngi merikol , murde tr @@lrpr @@kr @@u mz nz @@vz @@kr @@mq @@gr kc mz tewa kc etu .
Sc tqrpipebo mz Lrlvz nadwatrpzkr brma murde narlx-zpwxbzkr toki mz ncblo kc tqtutxpxm mz naonrx .	sc tq @@r @@pi @@pe @@bo mz Lrlvz na @@dwa @@tr @@bz @@kr brma murde na @@rlx @@zpwx @@bz @@kr toki mz ncblo kc tq @@tu @@tx @@px @@mq @@Ø mz naonrx .
Kx nzkrlzmlr kc Alankaula Skul , sc tztavetrpelr naonrx ngr stoa nyzgr .	kx nz @@krlz @@mq @@lr kc Alankaula skul , sc tz @@tave @@tr @@pe @@lr naonrx ngr stoa nyz @@gr .
Zbz pwx mou nzabzong mz nabznepi kc nzpnu'-nrade-li krlzbzle mz nourla .	zbz pwx mou nz @@abzo @@ng mz nabz @@nepi kc nzpnu @@nra @@de @@li krlz @@bz @@le mz nourla .
Mz zbq lc lxenge x lxe Lrlvz nzasung kai , lxkq , nesrkr , nc , nya x ninz kx nztabr .	mz zbq lc lxe @@nge x lxe Lrlvz nz @@a @@su @@ng kai , lxkq , nesrkr , nc , nya x ninz kx nz @@tabr .
Zbz mz nibrde dzbi kc tqvzpem , murde trpq , lxkq nesrkr x dakxnzng amrlxpe kzdung tqmibi , tqngrli x tqngilo .	zbz mz nibr @@de dzbi kc tq @@vz @@pe @@mq , murde trpq , lxkq nesrkr x dakxnzng amrlx @@pe kzdung tq @@mibi , tq @@ngrli x tq @@ngilo .
Taepis negr Mama Josis Balq , mzli lc trnikapqle mama .	taepis ne @@gr mama Josis Balq , mzli lc tr @@ni @@ka @@mq @@le mama .
Daniel Boerger abz-kzle kzdu nzryrngr mz vaol lcdeng .	Daniel Boerger abz @@kz @@le kzdu nzryrngr mz vaol lcdeng .
Zbz kzdu nidr nzpwxng badr Mr Lore sc tzvzopeng mz nzrmnq-krdr lue .	zbz kzdu nidr nz @@pwx @@ngq badr Mr lore sc tz @@vz @@o @@pe @@ng mz nz @@rmnq @@kr @@dr lue .
Mzli kc tqalilvcne-ngrde , bxn nedr Nevi sc tzakya'-kzpqng x tzayrni-kzpng dalr bxn bagr .	mzli kc tq @@alilvc @@ne @@ngr @@de , bxn ne @@dr Nevi sc tz @@akya' @@kz @@mq @@ng x tz @@ayrni @@kz @@mq @@ng dalr bxn bagr .
Ka-zvzbo narncbr lc badr murde pim Mista Lore .	ka @@zvz @@bo narncbr lc badr murde pi @@mq mista Lore .
X banyapu kcng tqwxbu-ngalelvzkr tutrng katris x toki kxtopwz li tutr katris x nzmeitrpz mz mq doa kcng tzryzkrng banyapu .	x banyapu kcng tq @@wxbu @@ngale @@lvz @@kr tutr @@ngq katris x toki kx @@topwz li tutr katris x nz @@mei @@tr @@pz mz mq doa kcng tz @@r @@yzkr @@ng banyapu .
Kx yzlumgr kc sc tqvztr-mopwzkr mz olvz kc tqyagox Mznanq .	kx yzlu @@mq @@gr kc sc tq @@vztr @@mou @@bz @@kr mz olvz kc tq @@yagox Mznanq .
X sc tqvzpe ma nyzde .	x sc tq @@vz @@pe ma nyz @@de .
Kzdq zbq olvz rnge Ellen yagox .	kzdq zbq olvz r @@nge Ellen yagox .
Kx obqkimc kc mq x trpnzngr doa kx mclx , sc tqyzlumipe-moux neimr kio kcng tq mrkc tqkakilzmclr .	kx obq @@ki @@mq @@x kc mq x trpnzngr doa kx mc @@x , sc tq @@yzlu @@mi @@pe @@mou @@x neimr kio kcng tq mrkc tq @@kalz @@ki @@lz @@mq @@x @@lr .
Nide lape .”	nide la @@pe .”
X rpibo bade kx , “ Drtwrnge matxbz nzrmc-krnge nrtq , a' nakrka'tx-kaiki murde namclx du kxesz'ne .	x r @@pi @@bo bade kx , “ drtwr @@nge ma @@tx @@bz nz @@r @@mc @@kr @@nge nrtq , a' na @@krka' @@tx @@kai @@ki murde na @@mc @@x du kx @@esz' @@ne .
Omitxpxbzle nigr prla , x nigr kc tqyapxpekr mz lcsu tqvopekr Malaita .	o @@mi @@tx @@px @@bz @@le nigr prla , x nigr kc tq @@ya @@px @@pe @@kr mz lcsu tq @@vo @@pe @@kr Malaita .
Da kx kctitxpxx mz tewa lcde etu , opxm kx drvr-ngrgr kc abrelz kxetu .	da kx kcti @@tx @@px @@x mz tewa lcde etu , opxm kx drvr @@ngr @@gr kc abrelz kx @@etu .
Zbz sc tzma-nqblqpelr , nzvzbzng x sc trnzmcpelru me nzvzkilr .	zbz sc tz @@ma @@nqblq @@pe @@lr , nz @@vz @@bz @@ng x sc tr @@nz @@mc @@pe @@lr @@u me nz @@vz @@ki @@lr .
Kx mc trtenge trnzkqlu-krpepwqgru kx nzmncng Narnztilolx , sc tqpipebzle badr mzledeng x Meleu nzvzo-krdr badr Nea .	kx mc trte @@nge tr @@nz @@kqlu @@kr @@pe @@pwq @@gr @@u kx nz @@mnc @@ngq Narnztilolx , sc tq @@pi @@pe @@bz @@le badr mzle @@de @@ngq x Meleu nz @@vz @@o @@kr @@dr badr Nea .
Twzkipxlele mz nctq Nemya' kc tqprkilzm nepi , x twztrle mz nartrkla ngr kzdq nrlc nzrpibz Nzo .	twz @@ki @@px @@le @@le mz nctq Nemya' kc tq @@prki @@lz @@mq nepi , x twz @@tr @@le mz nartrkla ngr kzdq nrlc nz @@r @@pi @@bz Nzo .
"Vztrkr badr brma nyzdr , sc tqrpipebz Jon mz olvz kc tqyagox kx , "" Trpnzngr luekxpiz kx nakabo kx namnqq , a' narlxtitxpo mz drka' negr , Gct , kc tqpibzkr bam kx nalxngiti-kzamu , nzkatxpx-krbzle zyagox kc tqdwatibzle nim murde drtqm namrlz mou ."""	"vz @@tr @@kr badr brma nyz @@dr , sc tq @@r @@pi @@pe @@bz Jon mz olvz kc tq @@yagox kx , "" trpnzngr luekxpiz kx na @@ka @@bo kx na @@mnq @@q , a' na @@rlxti @@tx @@bo mz drka' ne @@gr , Gct , kc tq @@pi @@bz @@kr bam kx na @@lxngiti @@kz @@amu , nz @@katx @@px @@kr @@bz @@le zyagox kc tq @@dwati @@bz @@le nim murde drtq @@mq na @@mrlz @@Ø mou ."""
Nzrpimlr nakabo du nadr kio kcng mz nabxbz kc .	nz @@r @@pi @@mq @@lr na @@ka @@bo du na @@dr kio kcng mz nabxbz kc .
Mnctix Boo yiz tq x ninge kc tqvzpex Nea mz 1953 , tqalvzpxpex kzdq skul elr .	mnc @@ti @@x Boo yiz tq x ninge kc tq @@vz @@pe @@x Nea mz 1953 , tq @@alvz @@px @@pe @@x kzdq skul elr .
Mztea nyzgr Narnztilolx ycpe pipz kz nzmznr-krde .	mztea nyz @@gr Narnztilolx yc @@pe pipz kz nz @@mznr @@kr @@de .
X mz nzngini-krnge kxrtekqtr , yzutrx mz yiz 1977 , x Nzryrngrkxtr kc ate yrkrpx mz yiz 2006 x buk lc nzamnqlvzngr mz yiz 2008 .	x mz nz @@ngini @@kr @@nge kx @@r @@tekqtr , yzu @@tr @@x mz yiz 1977 , x Nzryrngrkxtr kc ate @@Ø yrkrpx mz yiz 2006 x buk lc nz @@amnq @@lvz @@ngr mz yiz 2008 .
Ninge kc tqobqlzpex wq , mz nrlargr rlilr , mz nibrgr x mrkc tqvzkipxkr , tqmcpex nzdc-zlwzkr tewa .	ninge kc tq @@obq @@lz @@pe @@x wq , mz nrlar @@gr rlilr , mz nibr @@gr x mrkc tq @@vz @@ki @@px @@kr , tq @@mc @@pe @@x nz @@dc @@zlwz @@kr tewa .
Kx tqvzbo kc tewa kc tqdc .	kx tq @@vz @@bo kc tewa kc tq @@dc .
Prtztxbzkr x nigr kc tqvopxpe mz lcsu .	prtz @@tx @@bz @@kr x nigr kc tq @@vo @@px @@pe mz lcsu .
54 . Nzvz-krgr Mz Daniel Pauabu	54 . nz @@vz @@kr @@gr mz Daniel Pauabu
Gzpman mrkc Tulzgi sc tzatwzlrpe-ngrmlr kc lcsu drtqde Veronika , mz nzoti-krmle Dckta , Kzpten x kru nedrng .	gzpman mrkc Tulzgi sc tz @@atwzlr @@pe @@ngr @@mq @@lr kc lcsu drtq @@de Veronika , mz nz @@oti @@kr @@mq @@le dckta , kzpten x kru ne @@dr @@ngq .
Kx xlrbo nzycmne-krde ninge kc tqvzpex .	kx xlr @@bo nz @@ycmne @@kr @@de ninge kc tq @@vz @@pe @@x .
Sc tqrpipem kxetu kc , “ Yrbqoamu !”	sc tq @@r @@pi @@pe @@mq kx @@etu kc , “ yrbq @@o @@amu !”
X nigr kc tqrkqtipe , twztrkr mz zmio ngr kzdq nc ninz kx tu mrlcde , akiokr dzu rde tq , x sc tqwxbu-ngalelvzpekr dzu kcng tq .	x nigr kc tq @@r @@kq @@ti @@pe , twz @@tr @@kr mz zmio ngr kzdq nc ninz kx tu mrlcde , aki @@o @@kr dzu r @@de tq , x sc tq @@wxbu @@ngale @@lvz @@pe @@kr dzu kcng tq .
"Sc tqrpipebz kxetu r ami kc kx , "" E krlzpebo , murde nzmu nangi nimu enqmi , bzamu amrlx ngrmu ."	"sc tq @@r @@pi @@pe @@bz kxetu r ami kc kx , "" e krlz @@pe @@bo , murde nzmu na @@ngi nimu enqmi , bz @@amu amrlx ngr @@mu ."
Zbz sc tqvzmitrpeleng brma .	zbz sc tq @@vz @@mi @@tr @@pe @@le @@ng brma .
Mz yiz 1929 brtitx angidr mzke' kzdq nounenq kxetu .	mz yiz 1929 br @@ti @@tx angidr mz @@ke' kzdq nounenq kx @@etu .
A' rpwa'tx-ngrbo badr .	a' rpwa' @@tx @@ngr @@bo badr .
Zbz kzdq zbq kx nenq bao-ngrde mz tonga mzli kc rla , glqtxole nua'mu scde x sc tqyapxpe prla mz nzalvc-krde lika .	zbz kzdq zbq kx nenq bao @@ngr @@de mz tonga mzli kc rla , glq @@tx @@o @@le nua'mu sc @@de x sc tq @@ya @@px @@pe prla mz nz @@a @@lvc @@kr @@de lika .
Mncx elr x mz yiz 1963 doa negr ayrnrngr sc mzte tzmcpe , drtqde Churchill Pingalr .	mnc @@x elr x mz yiz 1963 doa ne @@gr ayrnr sc mz @@te tz @@mc @@pe , drtq @@de Churchill Pingalr .
Omi Saotzn Kros x sc tqpoope Pauabu .	o @@mi Saotzn Kros x sc tq @@po @@o @@pe Pauabu .
Kc tqmu nzycmne-krbo kc mzli kc kai , mz drtwrnge ma tqrblxtile nigu nztamititr-krgu nide , a' kx tqycmnepeamu bade sa tqmrlzpe , trpengr da napitr-moupo .	kc tq @@mu nz @@ycmne @@kr @@bo kc mzli kc kai , mz drtwr @@nge ma tq @@rblx @@ti @@le nigu nz @@tamiti @@tr @@kr @@gu nide , a' kx tq @@ycmne @@pe @@amu bade sa tq @@mrlz @@pe @@Ø , trpengr da na @@pi @@tr @@mou @@bo .
Lcsu kc tqaenzlikr kx vomle kc , sc tqrpipem kxetu rgr kx navopekr badr mz wop na-aglqpekr badr dztudr ami kcng naprom mz lcsu .	lcsu kc tq @@aenzli @@kr kx vo @@mq @@le kc , sc tq @@r @@pi @@pe @@mq kx @@etu r @@gr kx na @@vo @@pe @@kr badr mz wop na @@a @@glq @@pe @@kr badr dztu @@dr ami kcng na @@pr @@o @@mq mz lcsu .
Ninge , mulzpekr badr pripekt mz tebol nyzdr .	ninge , mu @@lz @@pe @@kr badr pripekt mz tebol nyz @@dr .
Doa kcng nzpwxng tzrlxtimlr kio ne Dckta Fox , kx nzmctr kc nzmwipe-krnge , sc tzvzpeng mz nabxbz kc , nztavetrlr naonrx , x nzglqpxmlr kio tq .	doa kcng nz @@pwx @@ngq tz @@rlx @@ti @@mq @@lr kio ne dckta Fox , kx nz @@mc @@tr kc nz @@mwi @@pe @@kr @@nge , sc tz @@vz @@pe @@ng mz nabxbz kc , nz @@tave @@tr @@lr naonrx , x nz @@glq @@px @@mq @@lr kio tq .
A' ninge kc tqwztrbex elr mzli ka , mz nztekqtr-krnge Nzryrngrkxtr kc kai .	a' ninge kc tq @@wz @@tr @@be @@x elr mzli ka , mz nz @@tekqtr @@kr @@nge Nzryrngrkxtr kc kai .
Zbz sc tqkapebo kzdq drtc' nyznge Bwrnebwr .	zbz sc tq @@ka @@pe @@bo kzdq drtc' nyz @@nge Bwrnebwr .
"Rpibz kxkz lcde mz ncblo kc tqvzbz bade kx , "" Yzlutxpe , navz-krlzpo kalrla ."	"r @@pi @@bz kxkz lcde mz ncblo kc tq @@vz @@bz bade kx , "" yzlu @@tx @@pe , na @@vz @@krlz @@bo kalrla ."
Nzrlasz-krgr Mzdxmingr trvzkru mz mztea kxesz' .	nz @@rlasz @@kr @@gr Mzdxmingr tr @@vz @@kr @@u mz mztea kx @@esz' .
Kx xlr Mzdealwx , kxetu ngr Nea , nzotipe-krm lcsu Dckta x dzbede nede , sc tqyapxpebz mz Kzpten ngr Veronika .	kx xlr Mzdealwx , kx @@etu ngr Nea , nz @@oti @@pe @@kr @@mq lcsu dckta x dzbede ne @@de , sc tq @@ya @@px @@pe @@bz @@Ø mz kzpten ngr Veronika .
Kx nzvolr kc sc tzpnz-nqblqpe lr Japan kcng , x nzpnzbzlr doa kcng esz' , doa lr Malaita , drtqde Tznbol Telenapo .	kx nz @@vo @@lr kc sc tz @@pnz @@nqblq @@pe lr Japan kcng , x nz @@pnz @@bz @@lr doa kcng esz' , doa lr Malaita , drtq @@de Tznbol Telenapo .
Dzbede lc ne Mr Lore nzmnctipxmlr peto wiki tq x sc tzkrlzpe-atelr Luga .	dzbede lc ne Mr Lore nz @@mnc @@ti @@px @@mq @@lr peto wiki tq x sc tz @@krlz @@pe @@ate @@lr Luga .
Mznr murde leplz ngrdeng nibqti kzdq zyagox kx nzpwrngr x nzngqbangr mepyr .	mznr @@Ø murde leplz ngr @@de @@ngq nibq @@ti kzdq zyagox kx nz @@pwr @@ngr x nz @@ngqba @@ngr mepyr .
Mzdealwx kx rlxngitile kc , sc tqrlrpebzle Bwzng mz tzsiu kcng , nangipe mztea nyzdr .	Mzdealwx kx r @@lxngiti @@le kc , sc tq @@rlr @@pe @@bz @@le Bwzng mz tzsiu kcng , na @@ngi @@pe mztea nyz @@dr .
Kru kcng nzbrlclvznepx-kzpq kxnzetu rgrng mz bot .	kru kcng nz @@brlclvz @@ne @@px @@kz @@mq kx @@nz @@etu r @@gr @@ngq mz bot .
A' trrlr-ngrpleu .	a' tr @@rlr @@ngr @@mq @@le @@u .
65 . Alvztrx Baengr Skul	65 . alvztr @@x Baengr skul
Mama Frank Bolen lc nide dalr Gwalekana .	mama Frank Bolen lc nide dalr Gwalekana .
Kzdq zbq vzm kc pulis Fiu .	kzdq zbq vz @@mq @@Ø kc pulis Fiu .
X kamle bange na-ayrkrpxx Nrpakxmrlz kc tqyr Luk , tqayzutxtr Mama Ini Lzpli , murde nzwz-krde kqlupe mz nzngini-krde Primiz .	x ka @@mq @@le ba @@nge na @@a @@yrkr @@px @@x Nrpakxmrlz kc tq @@yr Luk , tq @@ayzu @@tx @@tr mama Ini Lzpli , murde nz @@wz @@kr @@de kqlu @@pe mz nz @@ngini @@kr @@de Primiz .
Kzdq Satqde mzli kc milzpq rpim Dckta Foks bange navex Pawa mz nzamukxtr-krde mz Sade .	kzdq Satqde mzli kc milzpq r @@pi @@mq Dckta Foks bange na @@ve @@x Pawa mz nz @@a @@mu @@kx @@tr @@kr @@de mz Sade .
Tqyamgr nenq kc matqnepx .	tq @@ya @@mq @@gr nenq kc matq @@ne @@px .
Rpibz kxetu kc narpnz' dq kztede kcng .	r @@pi @@bz kx @@etu kc na @@r @@pnz' dq kzte @@de kcng .
Da krali kzdq olvz lr Mznanq kxyrlz yagox .	da kra @@li kzdq olvz lr Mznanq kx @@yrlz yagox .
Kx nzxlrbzlrle nzaolvzbzlr natqde x nzabrtzlvzlr .	kx nz @@xlr @@bz @@lr @@le nz @@aolvz @@bz @@lr natq @@de x nz @@abrtz @@lvz @@lr .
Nzmncng mz ma ngr takes kxmrna kx nztekqtrngr krkc tqyrwilx dxvo .	nz @@mnc @@ngq mz ma ngr takes kx @@mrna kx nz @@tekqtr @@ngr krkc tq @@yrvi @@lx dxvo .
17 . Lr Ncnqmz Nzycngr Drtwrdr Nigr	17 . lr Ncnqmz nz @@yc @@ngr drtwr @@dr nigr
Yzuo-moukr Vxngr x mwikr Neo .	yzuo @@mou @@kr Vxngr x mwi @@kr Neo .
Trpnzngr , a' zyagox ngr drtqde sc etunepx zlwz .	trpnzngr , a' zyagox ngr drtq @@de sc etu @@ne @@px zlwz .
Zbz kzdq ncboi kxtopwzne sc mwatipe lika nede .	zbz kzdq ncboi kx @@topwz @@ne sc mwa @@ti @@pe lika ne @@de .
Nzkrka'-krde boi , a' mrbrtitrpe drtwrnge kzdung natqde .	nz @@krka' @@kr @@de boi , a' mrbr @@ti @@tr @@pe drtwr @@nge kzdung natq @@de .
Nzadolz-moulr mz nyr x nrlc kc tqngrlxope x belo ngr nzkrka'ngr kc tqyrnipe .	nz @@a @@do @@lz @@mou @@lr mz nyr x nrlc kc tq @@ngrlx @@o @@pe x belo ngr nzkrka'ngr kc tq @@yrni @@pe @@Ø .
Mz nzmncpe-krgr kc mz kampi nzapx-ngrm bagr nzrmalvz-aepztr-krgr mz ma kcng tqyrlwrpx-ngrm dztudr ami x nzrmalvz-krgr mz lozbq .	mz nz @@mnc @@pe @@kr @@gr kc mz kampi nz @@apx @@ngr @@mq bagr nz @@r @@malvz @@aepz @@tr @@kr @@gr mz ma kcng tq @@yrlwr @@px @@ngr @@mq dztu @@dr ami x nz @@r @@malvz @@kr @@gr mz lozbq .
Kx xlrbzle nzryapwx-krdr , sc tqrpipemle bagr nadwaszpekr mrkc x narlalzkr mz newz .	kx xlr @@bz @@le nz @@ryapwx @@kr @@dr , sc tq @@r @@pi @@pe @@mq @@le bagr na @@dwasz @@pe @@kr mrkc x na @@rla @@lz @@kr mz newz .
Ninge ncblo kc ngi trtenge drtqde Maekol Usi x olvz rde drtqde Katerin .	ninge ncblo kc ngi trte @@nge drtq @@de Maekol Usi x olvz r @@de drtq @@de Katerin .
Nzveaneng da kx nangelungr a' trpnzngr , ngitxpwz kzdq dapu nc tabao kxglr trtakitru nabx .	nz @@vea @@ne @@ngq da kx na @@ngelu @@ngr a' trpnzngr , ngi @@txpwz kzdq dapu nc tabao kx @@glr tr @@takitr @@u nabx .
X mou , nzaelwa-kz-ngrbz dalr trau scgu .	x mou , nz @@aelwa @@kz @@ngr @@bz dalr trau sc @@gu .
61 . Nzyzlu-krmc Sada Krus	61 . nz @@yzlu @@kr @@mq @@o Sada Krus
Trkrlzwamu mzli ka mzlir vea ?	tr @@krlz @@amu @@u mzli ka mzlir vea ?
Yabzkr Dxi , ekqtxkr kumara x nya' nyz lrmztangi x kqtitx-kzkr ckrle kcng .	ya @@bz @@kr Dxi , ekq @@tx @@kr kumara x nya nyz lrmztangi x kq @@ti @@tx @@kz @@kr ckrle kcng .
A' doa lcdeng nztq nzmwelrng x nzdwaszdr nidr mz nrlckxbq me nzmwi-ngrdr .	a' doa lcdeng nz @@tq nz @@mwelr @@ng x nz @@dwasz @@dr nidr mz nrlckxbq me nz @@mwi @@ngr @@dr .
Zbz sc tqryrpebz mz kzpten ngr Saotzn Kros .	zbz sc tq @@r @@yr @@pe @@bz mz kzpten ngr Saotzn Kros .
Kx krlzpekr kc natq kcng tzayzlu mz nzwrkxtrngr sc tzaveatipe tzsiu kcng Mama Jos Wes vzm sc tqawrkxtrpele nigr .	kx krlz @@pe @@kr kc natq kcng tz @@a @@yzlu mz nz @@wrkxtr @@ngr sc tz @@a @@vea @@ti @@pe tzsiu kcng mama Jos Wes vz @@mq @@Ø sc tq @@awrkxtr @@pe @@le nigr .
X rpimle kx , “ Sa tqmrlz ye .”	x r @@pi @@mq @@le kx , “ sa tq @@mrlz ye .”
Mzli kc rla bot kc tqotitrpemle nidr .	mzli kc rla bot kc tq @@oti @@tr @@pe @@mq @@le nidr .
Mzdealwx nidr mz trtenge Melomate trnzlxngitikalr Nrpakxmrlz .	Mzdealwx nidr mz trte @@nge Melomate tr @@nz @@lxngiti @@ka @@lr Nrpakxmrlz .
Matelq lcng , esz'mz nayctipxm dztudr ami x pwx nangi nyzgr .	matelq lcng , esz'mz na @@yc @@ti @@px @@mq dztu @@dr ami x pwx na @@ngi nyz @@gr .
Kxnzetu rgrng nzvz ma kc tzmwi-ngrdr , nzglqlzmlr Dckta x Kzpten , sc tzangrlvzneopelr , nzangrlvznedr x nzglqolr mz bot .	kx @@nz @@etu r @@gr @@ngq nz @@vz ma kc tz @@mwi @@ngr @@dr , nz @@glq @@lz @@mq @@lr dckta x kzpten , sc tz @@angrlvz @@ne @@o @@pe @@lr , nz @@angrlvz @@ne @@dr x nz @@glq @@o @@lr mz bot .
A' vea-kapq ngr mzli ka trnzayotipelru nqvi lr ncblo mz nzrnibqngr .	a' vea @@kapq ngr mzli ka tr @@nz @@ayo @@ti @@pe @@lr @@u nqvi lr ncblo mz nz @@r @@nibq @@ngr .
Nzveclzmlr agz x sc tzawztrpelr enjin .	nz @@vec @@lz @@mq @@lr agz x sc tz @@a @@wz @@tr @@pe @@lr enjin .
Ncblo kcng amrlx nzalvzting mz skul ngitxpwz tzsiu , x Hedmastz Dckta Foks .	ncblo kcng amrlx nz @@alvz @@ti @@ngq mz skul ngi @@txpwz tzsiu , x hedmastz Dckta Foks .
Kzdq rum ngrde mwi-ngrgr badr trtenge x kzdq rum tupx-ngrm mqngr Ncbr , a' trkrlzwxu mqngr Ncbr kc tqtupxm elr .	kzdq rum ngr @@de mwi @@ngr @@gr badr trte @@nge x kzdq rum tu @@px @@ngr @@mq mqngr ncbr , a' tr @@krlz @@x @@u mqngr ncbr kc tq @@tu @@px @@mq elr .
Doa kx nzmwipxm elr nzvzpeng mrnyzdr murde vea kc .	doa kx nz @@mwi @@px @@mq elr nz @@vz @@pe @@ng mrnyz @@dr murde vea kc .
Wztitxkr x atulztxkr ma ngrdeng amrlx , x Mista Dxvo badr doa kxnzsiklung sc tqasiklupeleng elr .	wz @@ti @@tx @@kr x atulz @@tx @@kr ma ngr @@de @@ngq amrlx , x mista Dxvo badr doa kx @@nz @@siklu @@ng sc tq @@a @@siklu @@pe @@le @@lengq elr .
Oliqlzkr rlilrgr x nigr kc tqvzpekr .	oliq @@lz @@kr r @@li @@r @@gr x nigr kc tq @@vz @@pe @@kr .
Drtq mztea lcdeng nidr seleng : Baengr , Nzlqwc , Mzjzbxlo , Ncmix , Bapo , Mznanq , Mznzmipc' , Neboi , Ncnqmz , Mancu , Ncole , Nepr , Ncnia x Nebrnz .	drtq mztea lc @@de @@ng nidr seleng : Baengr , Nzlqwc , Mzjzbxlo , Ncmix , Bapo , Mznanq , Mznzmipc' , Neboi , Ncnqmz , Mancu , Ncole , Nepr , Ncnia x Nebrnz .
X ata-lxblrkr nzlu mz planteson , kzporapekr , rglqkr bxki r nzlu mz draea , aglrkr x rglqpxkr bxki r kzpora mz digi mz nzo-krm Saotzn Kros mz skul .	x ata @@lxblr @@kr nzlu mz planteson , kzpora @@pe @@kr , r @@glq @@kr bxki r nzlu mz draea , a @@glr @@kr x r @@glq @@px @@kr bxki r kzpora mz digi mz nz @@o @@kr @@m Saotzn Kros mz skul .
Nzkalzmlr kio kcng mz nzwrde krapwx , a' trpnzngrpwz mepyr ngrde kc tqvopwz x nzglqlz-moulr mz nyr .	nz @@kapx @@lz @@mq @@lr kio kcng mz nzwr @@de kra @@pwx , a' trpnzngr @@pwz mepyr ngr @@de kc tq @@vo @@pwz x nz @@glq @@lz @@mou @@lr mz nyr .
Mztr nzmc mz mzlir yiz kcng 1800 x nzbzng mz mzlir yiz kcng 1900 .	mz @@tr nz @@mc mz mzlir yiz kcng 1800 x nz @@bz @@ng mz mzlir yiz kcng 1900 .
Zbz mz Zbq sc Mateas sc tzmcpx-moulr ninge mz nzngini-krnge kxetu r dzbede kcng tq mz makxtr kc Balo .	zbz mz zbq sc Mateas sc tz @@mcpx @@mou @@lr ninge mz nz @@ngini @@kr @@nge kx @@etu r dzbede kcng tq mz makxtr kc Balo .
Dckrlzde Kc Rpwxmz	dckrlzde kc rpwxmz
Vztr-moukr mz kzdq bute' ngr ma kc , sc tqmcpekr belenga ngr nar kxkqlu .	vz @@tr @@mou @@kr mz kzdq bute' ngr ma kc , sc tq @@mc @@pe @@kr belenga ngr nar kx @@kqlu .
Nzmu drtwrde kx tqmrlz-moule , nzkrlztrpz nike tqtrkangr drtwrde .	nzmu drtwr @@de kx tq @@mrlz @@mou @@le , nz @@krlz @@tr @@pz nike tq @@trka @@ngr drtwr @@de .
Murde trnangipeu skul kx namwingr doa kxnzsiklu , a' nangipe skul kx navzkitxpwzlr mz nzsiklungr .	murde tr @@na @@ngi @@pe @@u skul kx na @@mwi @@ngr doa kx @@nz @@siklu , a' na @@ngi @@pe skul kx na @@vz @@ki @@tx @@pwz @@lr mz nz @@siklu @@ngr .
X rpimle kx , “ Nike tqyrkelvzq ?”	x r @@pi @@mq @@le kx , “ nike tq @@yrke @@lvz @@q ?”
Mzli kc ayrnrngr trnzaolvzpwzu kxnzetu rgrng nzlxngiti-krgr Nrpakxmrlz .	mzli kc ayrnr tr @@nz @@aolvz @@pwz @@u kx @@nz @@etu r @@gr @@ngq nz @@lxngiti @@kr @@gr Nrpakxmrlz .
Ami kc nztulzm x pu scdr nzaobq-lxblrbzlr badr doa kcng .	ami kc nz @@tu @@lz @@mq x pu sc @@dr nz @@a @@obq @@lxblr @@bz @@lr badr doa kcng .
Kx nzmc doa kcng nide sc tzmwelrng , murde kio nede kcng tzpnatibzlr .	kx nz @@mc doa kcng nide sc tz @@mwelr @@ng , murde kio ne @@de kcng tz @@pnati @@bz @@lr .
Mqnge rlilr kx nzbrkapxmlr kc mz nc bia kc , ninge kc tqdotrpex mz dzbr lemwzlo kc esz' .	mq @@nge r @@li @@r kx nz @@brka @@px @@mq @@lr kc mz nc bia kc , ninge kc tq @@do @@tr @@pe @@x mz dzbr lemwzlo kc esz' .
Dckta badr kru kcng nzprtz-mopwzng mz lcsu nzrtrngrtiolr Kzpten , nzrtco-ngrdr mz bot .	dckta badr kru kcng nz @@prtz @@mou @@bz @@ngq mz lcsu nz @@rtrngr @@ti @@o @@lr kzpten , nz @@rtc @@o @@ngr @@dr mz bot .
Rpi-mopwz Dckta Fox kx , “ Yolxomamu supe da la .”	rpi @@mou @@bz dckta Fox kx , “ yolx @@o @@mq @@amu supe da la .”
58 . Wzx Mz Saotzn Kros 7	58 . wz @@x mz Saotzn Kros 7
Zbz kzdq zbq sc tzrmctipelr kc dzbe lr Japan .	zbz kzdq zbq sc tz @@rmcti @@pe @@lr kc dzbe lr Japan .
X kzdq kz da , buk tq nzwz-krgrle kxesz' .	x kzdq kz da , buk tq nz @@wz @@kr @@gr @@le kx @@esz' .
Nigr kcng navzng , nigr kc tqrkalzpemgr , vzkipebzkr mz newz .	nigr kcng na @@vz @@ng , nigr kc tq @@rkalz @@pe @@mq @@gr , vz @@ki @@pe @@bz @@kr mz newz .
70 . Wzx mz Kcoporetiv Sosaeti	70 . wz @@x mz Kcoporetiv Sosaeti
X ikzkr peto , lzokr nounc ngrde , angctikr , houkr x petikr .	x ikz @@kr peto , lz @@o @@kr nounc ngr @@de , a @@ngc @@ti @@kr , hou @@kr x pe @@ti @@kr .
Kx xlrbole , ninge kc tqvztrpebo mz naonrx .	kx xlr @@bo @@le , ninge kc tq @@vz @@tr @@pe @@bo mz naonrx .
Obqobz sc tqmcpele doa kcng tzkuking kio .	obq @@o @@bz sc tq @@mc @@pe @@le doa kcng tz @@kuki @@ng kio .
Mz yiz 1958 nzoliqngr kxetu nzrtrngrtibz mrka Nabakxenga .	mz yiz 1958 nz @@oliq @@ngr kx @@etu nz @@rtrngr @@ti @@bz mrka Nabakxenga .
Kx nzlutxpwzng nzbzti-alzung mz vea-kapq .	kx nz @@lu @@tx @@pwz @@ngq nz @@bz @@ti @@alzu @@ngq mz vea @@kapq .
40 . Merikol Krali Mz Mzli R Vea	40 . merikol kra @@li mz mzli R vea
Mzli lc vea tryrkrpx-zpwxka murde lr Japan kcng tzyrlwrtinebe peto .	mzli lc vea tr @@yrkr @@px @@zpwx @@ka murde lr Japan kcng tz @@yrlwr @@ti @@ne @@be peto .
Temz otxpx li x sc tzprtr-mopwq kcng leplz bagr nigr kcng tzrlxngiti-kaing .	temz otxpx li x sc tz @@prtr @@mou @@mq kcng leplz bagr nigr kcng tz @@r @@lxngiti @@kai @@ngq .
Rlaszkr nc nzlu kc , xlrbzkr mz nibrgr nc nzlu kc yrpupe bzprlzpem mz noude .	rlasz @@kr nc nzlu kc , xlr @@bz @@kr mz nibr @@gr nc nzlu kc yrpu @@pe bz @@pr @@lz @@pe @@mq mz nou @@de .
Krlc nqvi lr lika .	krlc nqvi lr lika .
A' kx na-ayrplapxxng doa lr Pawa Skul kcng tztavetrlr naonrx ngr stoa nyzgu x tzrtwzting da .	a' kx na @@ayrplapx @@x @@ngq doa lr Pawa skul kcng tz @@tave @@tr @@lr naonrx ngr stoa nyz @@zgu x tz @@rtwz @@ti @@ng da .
Zbz kzdq zbq sc tqrpipebzle mz Rik kx navztx kai Mzlo .	zbz kzdq zbq sc tq @@r @@pi @@pe @@bz @@le mz Rik kx na @@vz @@tx kai Mzlo .
A' lr Japan kcng sc tzaki-lzbqpe , kzdq vzkimle prla x kzdq vzkipemle mz lrpzki .	a' lr Japan kcng sc tz @@aki @@lzbq @@pe , kzdq vz @@ki @@mq @@le prla x kzdq vz @@ki @@pe @@mq @@le mz lrpzki .
32 . Doa Kx Nzpnang Kio Mz Niu Yiz	32 . doa kx nz @@pna @@ng kio mz Niu Yiz
Krlc merikol krali .	krlc merikol kra @@li .
Kzdq zbq sc tqpipem Katkis Esuz Balo kx naokatrx nide mz nzrlwxngr nzkrka'ngr mz makxtr x nayapwx-kzx mz Sade x zbqkxtr .	kzdq zbq sc tq @@pi @@pe @@m katkis Esuz Balo kx na @@okatr @@x nide mz nzrlwxngr nzkrka'ngr mz makxtr x na @@yapwx @@kz @@x mz Sade x zbq @@kx @@tr .
Itange x blrkqnge drtqdr Naplosx x Ilztrkalr .	ita @@nge x blrkq @@nge drtq @@dr Naplosx x Ilztrkalr .
Trtenge sc tqryapwxpem bagr mz nzlc-apqbzngr x nzalvztrngr .	trte @@nge sc tq @@r @@yapwx @@pe @@mq @@Ø bagr mz nz @@lc @@a @@pq @@bz @@ngr x nz @@alvztr @@ngr .
Kzdq zbq kx mcpxm ncblo ngrde tzsiu Jon kc tqvz-nqblqnene , sc tqngrlrpxpem mz Jon , tqpipebzle kx olvz rde kc tqyagox .	kzdq zbq kx mc @@px @@mq ncblo ngr @@de tzsiu Jon kc tq @@vz @@nqblq @@ne @@ne , sc tq @@ngrlr @@px @@pe @@mq @@Ø mz Jon , tq @@pi @@pe @@bz @@le kx olvz r @@de kc tq @@yagox .
Rpile kx nzmu kx tqngi trpnzngr nagr dakxnzng , navzbzkr Tzngarare murde naokatrpqlr nigr mz nzmungr .	r @@pi @@le kx nzmu kx tq @@ngi trpnzngr na @@gr dakxnzng , na @@vz @@bz @@kr Tzngarare murde na @@okatr @@mq @@lr nigr mz nz @@mu @@ngr .
Mnctix Alankaula mz nzokatrngr nidr mz nzalvzngr yiz esz' x ncte kc .	mnc @@ti @@x Alankaula mz nzokatrngr nidr mz nzalvzngr yiz esz' x nctq @@de kc .
Nzvecng x nzdwaszbz lr Japan nrlc badr .	nz @@vec @@ng x nz @@dwasz @@bz lr Japan nrlc badr .
Nzrpimlr bagr kx napibzkr mz Mama Wili nzvzo-krmopwqkr kalrla , murde navz du badr nigr mrkc Veranaso .	nz @@r @@pi @@mq @@lr bagr kx na @@pi @@bz @@kr mz mama Wili nz @@vz @@o @@kr @@mou @@mq @@kr kalrla , murde na @@vz du badr nigr mrkc Veranaaso .
A' mrlxm lc tqngi Saemon krlz-angidrkr nide , ryapwx-zvzkr badr , vznekr badr mz nzwz-krgr x yapwxti-zvzbzkr bade kxmu nzmncngr mz skul .	a' mrlx @@mq lc tq @@ngi Saemon krlz @@angidr @@kr nide , r @@yapwx @@zvz @@kr badr , vzne @@kr badr mz nz @@wz @@kr @@gr x yapwx @@ti @@zvz @@bz @@kr bade kxmu nz @@mnc @@ngr mz skul .
Takitrtxpwz wiki kx li x nigr kc tqmupekr nzlu kxpo x kxglr x tqmupe-kzkr naq kxplc .	takitr @@tx @@pwz wiki kx li x nigr kc tq @@mu @@pe @@kr nzlu kx @@po x kx @@glr x tq @@mu @@pe @@kz @@kr naq kx @@plc .
Mz nibrde , nzalebz kxnzetu rgrng kc me nangi nrz mz nabz drta' Bwzng .	mz nibr @@de , nz @@ale @@bz kx @@nz @@etu r @@gr @@ngq kc me na @@ngi nrz mz nabz drta' Bwzng .
Kxli e kxtq , dela tzpresinqng .	kx @@li e kx @@tq , dela tz @@presin @@ngq .
Rlapxx elr murde nzkqle-krnge drtq kc tqngi Jiszs tqmatq-esz'ngr x angidati-pnzle mzli lcdepwz .	rlapx @@x elr murde nz @@kqle @@kr @@nge drtq kc tq @@ngi Jiszs tq @@matq @@esz'ngr x angida @@ti @@pnz @@le mzli lcde @@pwz .
Nzvztrng mz ma kx nzmwingr amrlx , kx nzsiklungr amrlx , krnyzdr kxnzalvzting amrlx , ma ngr nzmungr x makxtr .	nz @@vz @@tr @@ng mz ma kx nz @@mwi @@ngr amrlx , kx nz @@siklu @@ngr amrlx , krnyz @@dr kx @@nz @@alvz @@ti @@ng amrlx , ma ngr nz @@mu @@ngr x makxtr .
A' bot scgr nzvo-krde me ycngr nrwx , krlztx-zpwxbzle nabz drta' mrkc Nepa' .	a' bot sc @@gr nz @@vo @@kr @@de me yc @@ngr nrwx , krlz @@tx @@zpwx @@bz @@le nabz drta' mrkc Nepa' .
A' kx krlzmgr kc Akanipua , tewa kc tqetunepxpe mou .	a' kx krlz @@mq @@gr kc Akanipua , tewa kc tq @@etu @@ne @@px @@pe mou .
Rpibzle kx nadwatitx mou dq zbq lcsu scde , murde na-ale-kaipzng nzmungr mz Dckta x dzbede nede x aolvzbz Kzpten ngr Veronika .	r @@pi @@bz @@le kx na @@dwa @@ti @@tx mou dq zbq lcsu sc @@de , murde na @@ale @@kai @@bz @@ng nz @@mu @@ngr mz dckta x dzbede ne @@de x aolvz @@bz kzpten ngr Veronika .
Kxetu kc tqtwzle nigr mz kosi kc drtqde Mista Manfoot x nide kz kc tqngi kxetu r Alankaula Skul .	kx @@etu kc tq @@twz @@le nigr mz kosi kc drtq @@de mista Manfoot x nide kz kc tq @@ngi kx @@etu r Alankaula skul .
Dwakr x mnc-kapq-ngrgr kc nrlc peto .	dwa @@kr x mnc @@kapq @@ngr @@gr kc nrlc peto .
18 . Lcsu Aijz Vom Mz Trmctu Provins	18 . lcsu Aijz vo @@mq mz trmctu provins
Zbz Dckta , kx lxlvrkimle kc mq mz nzka-krmle abrelz scde murde nadrvr-ngrbo bxli scde kc tqlux , nrlar narde kxmc sc tqyrplatrpe mz kzdq nc nzlu kxyrngzpxm mz lrpzki .	zbz dckta , kx lxlvr @@ki @@mq @@le kc mq mz nz @@ka @@kr @@mq @@le abrelz sc @@de murde na @@drvr @@ngr @@bo bxli sc @@de kc tq @@lu @@x , nrlar nar @@de kx @@mc sc tq @@yrpla @@tr @@pe mz kzdq nc nzlu kx @@yrngz @@px @@mq mz lrpzki .
Kx xlrlele abrtztx-ngrde , x rpimle bange kx narlxtibo nide bam , murde navz mz skul .	kx xlr @@le @@le abrtz @@tx @@ngr @@de , x r @@pi @@mq @@le bange kx na @@rlxti @@bo nide bam , murde na @@vz @@Ø mz skul .
Dxvo lcde atrkatitx-atwrnr-ngrde mztea nyzgr Bokapwr .	dxvo lcde a @@trka @@ti @@tx @@atwrnr @@ngr @@de mztea nyz @@gr Bokapwr .
Mz nzalvztrngr leplz nzrlwxngr x nzryrngr mz Natqgu , Kennedy Clq mailzle nzwzngr lc , nidr badr Mathias Meabr x Susi Loki Clq .	mz nz @@alvztr @@ngr leplz nzrlwxngr x nzryrngr mz Natqgu , Kennedy Clq mailz @@le nz @@wz @@ngr lc , nidr badr Mathias Meabr x Susi Loki Clq .
Alvztrtx-ngrne Mona Skul yiz tq x tzatwzlr-moulr ninge mz skul kzble .	alvztr @@tx @@ngr @@ne Mona Skul yiz tq x tz @@atwzlr @@mou @@lr ninge mz skul kzble .
X yzuo-moukr Nepr x mwikr Nea .	x yzuo @@mou @@kr Nepr x mwi @@kr Nea .
Kzdu doa nztq nzrpilr natwzbzlr , a' trpnzngr peao kx nangelune-ngrdr .	kzdu doa nz @@tq nz @@r @@pi @@lr na @@twz @@bz @@lr , a' trpnzngr peao kx na @@ngelu @@ne @@ngr @@dr .
Krka'txkr , mrlz rtrngrtiox tosi x pct kxtopwzne x ninge kc tqvzopex prla .	krka' @@tx @@kr , mrlz rtrngr @@ti @@o @@x tosi x pct kx @@topwz @@ne x ninge kc tq @@vz @@o @@pe @@x prla .
Zbz kzdq zbq kx mncne-mou-ngrgr mz Lrlvz bea , oszbzle kc tabao kxplc mz nc tabao kx tutrpz yz mz rum kc tqtupx-ngrm mqngr Ncbr .	zbz kzdq zbq kx mnc @@ne @@mou @@ngr @@gr mz Lrlvz bea , osz @@bz @@le kc tabao kx @@plc mz nc tabao kx tu @@tr @@pz @@Ø yz mz rum kc tq @@tu @@px @@ngr @@mq mqngr ncbr .
A' nqmq ngr skul lc xplr zlwz , murde neke rnzlvzole nqmq ngr skul nziklapwz , x bz-ngrde nzpnu-esz'-nrade-li pwz .	a' nqmq ngr skul lc xplr zlwz , murde neke rnzlvz @@o @@le nqmq ngr skul nz @@ikla @@pwz , x bz @@ngr @@de nzpnu @@esz' @@nra @@de @@li pwz .
Rpibz tzsiu kc mz Mzdealwx kx , “ Trpnzngr luekxpiz kx nakabzkr namnqq , a' narlxtitx-pwzkr mz drka' negr kc drtqde Gct nzkatx-krbzle zyagox ngr drtqm murde drtqm namrlz mou .”	r @@pi @@bz tzsiu kc mz Mzdealwx kx , “ trpnzngr luekxpiz kx na @@ka @@bz @@kr na @@mnq @@q , a' na @@rlx @@ti @@txpwz @@kr mz drka' ne @@gr kc drtq @@de Gct nz @@katx @@kr @@bz @@le zyagox ngr drtq @@mq murde drtq @@mq na @@mrlz @@Ø mou .”
Drka' lcng nzrkabz badr nqmq kxtrka x drtwr kxtrka .	drka' lcng nz @@r @@ka @@bz badr nqmq kx @@trka x drtwr kx @@trka .
66 . Alvztr-moux Mona Skul	66 . alvztr @@mou @@x Mona skul
Nzobqbzng mzli kc Bwzng yrplabrtqpe mz nrc ngr maboi kcng li mz nctq Trmctu Nemya' rlilr , x nqvi lr bot scdr yapilwztrpe mz prcpelz ngr Aijz .	nz @@obq @@bz @@ngq mzli kc Bwzng yrpla @@brtq @@pe mz nrc ngr maboi kcng li mz nctq trmctu Nemya' r @@li @@r , x nqvi lr bot sc @@dr yapilwz @@tr @@pe @@Ø mz prcpelz ngr Aijz .
Otibz kxetu kc pu kc , pnz'-moule mrlx kc x sc tqbzpe .	oti @@bz kx @@etu kc pu kc , pnz' @@mou @@le mrlx kc x sc tq @@bz @@pe .
Kx mclzkr ma kc tqtuom mz newz lc , sc tqrpipem Lrlvz navzdzkr elr murde narlxtrpzkr toki kx naryzkr-ngrgr noli .	kx mc @@lz @@kr ma kc tq @@tu @@o @@mq @@Ø mz newz lc , sc tq @@r @@pi @@pe @@mq Lrlvz na @@vz @@dz @@kr elr murde na @@rlx @@tr @@bz @@kr toki kx na @@r @@yzkr @@ngr @@gr noli .
05 . Mqngr Ncbr x Da kx Tutr-mcpq Bange	05 . mqngr ncbr x da kx tutr @@mou @@pq bange
Diksonare kxtopwz kc kai lc tzkamlr bagu mz yiz kc 2005 mz buk kc tzrpibz , “ Nzryrngrkxtr Kc Ate x Sam .”	diksonare kx @@topwz kc kai lc tz @@ka @@mq @@lr bagu mz yiz kc 2005 mz buk kc tz @@r @@pi @@bz , “ nzryrngrkxtr kc ate @@Ø x Sam .”
08 . Trtenge Lc-apqbzle x Alvztrle Nigr	08 . trte @@nge lc @@a @@pq @@bz @@le x alvztr @@le nigr
"Kx yrkrpx kc temz kx li mz nzwz-krgr , sc tqveapem bange , rpimle kx , "" Nzxpepem mz nzwz-krgi lc ?"""	"kx yrkrpx kc temz kx li mz nz @@wz @@kr @@gr , sc tq @@vea @@pe @@mq bange , r @@pi @@mq @@le kx , "" nz @@xpe @@pe @@mq mz nz @@wz @@kr @@gi lc ?"""
Kxetu rgr prngeitxbz , sc tqpnz'pele mz pu pistol , bztxpnz' , x nigr kc tqo-zliopekr lue kc .	kx @@etu r @@gr prngei @@tx @@bz , sc tq @@pnz' @@pe @@le mz pu pistol , bz @@tx @@pnz , x nigr kc tq @@o @@zli @@o @@pe @@kr lue kc .
Kx mcomq ncblo kc tqaokz mz tawa nidr trpu kc tqayrnipele .	kx mc @@o @@mq ncblo kc tq @@aokz mz tawa nidr trpu kc tq @@a @@yrni @@pe @@le .
Mwakr badr prla , mwakr peto mz nzvzmi-krgr kuli x wzkr badr mz nrlanc .	mwa @@kr badr prla , mwa @@kr peto mz nz @@vz @@mi @@kr @@gr kuli x wz @@kr badr mz nrlanc .
Mwi-ngrgr peto nrlc nzlvqn x sc tqkrlz-atebzkr Tzngarare .	mwi @@ngr @@gr peto nrlc nzlvqn x sc tq @@krlz @@ate @@bz @@kr Tzngarare .
"Kxetu kc nangi kxetu rgr , vom mrkc tqpro-ngrgr mz trak , sc tqrpipemle bagr kx , "" Ycbepq lang zbq tq , x lcsu kc nartwzm dztu ami kcng naaglqamu sc tqkaputrpem ."	"kx @@etu kc na @@ngi kx @@etu r @@gr , vo @@mq mrkc tq @@pr @@o @@ngr @@gr mz trak , sc tq @@r @@pi @@pe @@mq @@le bagr kx , "" yc @@be @@mq la @@ngq zbq tq , x lcsu kc na @@rtwz @@mq dztu ami kcng na @@a @@glq @@amu sc tq @@kapu @@tr @@pe @@mq ."
34 . Doa Kcng Nzpnang Kio Nzmwxlrng	34 . doa kcng nz @@pna @@ng kio nz @@mwxlr @@ng
X Jim Menapi x olvz rde Lxede Lrmz , nidr badr Cecil Mona , Imanuel Menrq , Elizabeth Ilovz , Anika Iwxbu , x Emily Yrngao nzokatr-kzplr nigr mz nzatubqti-krdr kzdung natq mz nzrtekqtrngr lc .	x Jim Menapi x olvz r @@de lxe @@de Lrmz , nidr badr Cecil Mona , Imanuel Menrq , Elizabeth Ilovz , Anika Iwxbu , x Emily Yrngao nz @@okatr @@kz @@mq @@lr nigr mz nz @@atubq @@ti @@kr @@dr kzdung natq mz nz @@r @@tekqtr @@ngr lc .
56 . Nzryzutrngr Mou Nzsiklungr Veranaso	56 . nz @@r @@yzu @@tr @@ngr mou nz @@siklu @@ngr Veranaaso
Kzdq kc zbq mz yiz 1932 , vzm kc nengq kxetu vz-nqblqm dxvo ngrde kxetu .	kzdq kc zbq mz yiz 1932 , vz @@mq @@Ø kc nengq kx @@etu vz @@nqblq @@mq dxvo ngr @@de kx @@etu .
Lr Japan kcng li nzvzbzng sc tzrtangrpe mrkc nzrtcolzbq-ngrdr doa kcng mz nou kros kc .	lr Japan kcng li nz @@vz @@bz @@ng sc tz @@rtangr @@pe mrkc nz @@rtc @@o @@lzbq @@ngr @@dr doa kcng mz nou kros kc .
Pripekt kc sc tqoliqtipebzle olta x tqayrnipe belo .	pripekt kc sc tq @@oliq @@ti @@pe @@bz @@le olta x tq @@a @@yrni @@pe belo .
Nzrpim doa lr Fiu bagr kx navzkr Pauabu mz zbq kcpe tqpi pulis kc murde zbq sc kansrl x lrpzki yrbu .	nz @@r @@pi @@mq doa lr Fiu bagr kx na @@vz @@kr Pauabu mz zbq kc @@pe tq @@pi pulis kc murde zbq sc kansrl x lrpzki yrbu .
Vzbzkr x kzdq la Japan tqvzkilzmle prla kilznede kc peao .	vz @@bz @@kr x kzdq la Japan tq @@vz @@ki @@lz @@mq @@le prla kilz @@ne @@de kc peao .
Mz temz Disebz , Asdikon Are Renols , kxetu r skul amrlx ne Aglikan , vzbz mz Kzpten sc tqrlxtipebzle ninge .	mz temz Disebz , Asdikon Are Renols , kx @@etu r skul amrlx ne Aglikan , vz @@bz mz kzpten sc tq @@rlxti @@pe @@bz @@le ninge .
Krlcng olvi kcng nzrmale da kcng xpex .	krlcng olvi kcng nz @@r @@male da kcng xpe @@x .
Kx xlrkrle nigr kc tqmwelrpekr .	kx xlr @@kr @@le nigr kc tq @@mwelr @@pe @@kr .
Rpimle kx navzne x naalvztrx Mzlo Skul , murde sc trtqvz-zpwxu .	r @@pi @@mq @@le kx na @@vz @@ne x na @@alvztr @@x Mzlo Skul , murde sc tr @@tq @@vz @@zpwx @@u .
Nigr lcdeng krka'nepwzkr badr tzsiu yz , murde nzrpwa'-ngrbzlr badr tzsiu nzkrka'px-krmlr mz ma kc tzmwipx-ngrmlr .	nigr lcdeng krka' @@ne @@pwz @@kr badr tzsiu yz , murde nz @@rpwa' @@ngr @@bz @@lr badr tzsiu nz @@krka' @@px @@kr @@mq @@lr mz ma kc tz @@mwi @@px @@ngr @@mq @@lr .
Dzbede kc tqtwzx dzbede krali .	dzbede kc tq @@twz @@x dzbede kra @@li .
"Kx vzne kc mz lrpzki sc tqxlrpex kc natq kx ycmne-kimle mz nibrnge rpimle kx , "" Dakc nzwrde tq tqrpwa'-ngrbzme badr doa kcng nide la tqrtrngrtibzme kx tqrpirn narlapxq ."	"kx vz @@ne kc mz lrpzki sc tq @@xlr @@pe @@x kc natq kx ycmne @@ki @@mq @@le mz nibr @@nge r @@pi @@mq @@le kx , "" da @@kc nzwr @@de tq tq @@rpwa' @@ngr @@bz @@me badr doa kcng nide la tq @@rtrngr @@ti @@bz @@me kx tq @@r @@pi @@r @@n na @@rlapx @@q ."
Vzne Mzlo sc tqrmctipex kx skul trpnzngr leplz kxalvztr elr .	vz @@ne Mzlo sc tq @@r @@mc @@ti @@pe @@x kx skul trpnzngr leplz kx @@alvztr elr .
Mz zbq kcng tzsikluti , yzutr mzbq kx nzotrngr krlzbzle zbq kranzlvqn , trpnzngr mzli kx yc-nrbalq , a' mzli amrlx yctrpengr vz krlzbzle nrlckxbq .	mz zbq kcng tz @@siklu @@ti , yzutr mzbq kx nz @@o @@tr @@ngr krlz @@bz @@le zbq kranzlvqn , trpnzngr mzli kx yc @@nrbalq , a' mzli amrlx yc @@tr @@pe @@ngr vz krlz @@bz @@le nrlckxbq .
Yao kz Nzlvz mz nzwz-krde .	ya @@o @@Ø kz Nzlvz mz nz @@wz @@kr @@de .
Mista Lore x doa kcng nidr badr nzvzdzmqng .	mista Lore x doa kcng nidr badr nz @@vz @@dz @@mq @@ng .
A' lr Japan kcng nzvzkiope-kzlr prla , sc tzngrlrlz-moupq .	a' lr Japan kcng nz @@vz @@ki @@o @@pe @@kz @@lr prla , sc tz @@ngrlr @@lz @@mou @@mq @@ng .
Lcsu lc tqrtangrne ncblo kx na-aglqbzlr dalr nzvecngr scdr ami .	lcsu lc tq @@rtangr @@ne ncblo kx na @@a @@glq @@bz @@lr dalr nzvecngr sc @@dr ami .
Kzdq zbq sc tqpipem Mama Wili bagr nzrtangrti-krgr lclr teomo tqyrm Mr Atq letz ngrde .	kzdq zbq sc tq @@pi @@pe @@m mama Wili bagr nz @@rtangr @@ti @@kr @@gr lclr teomo tq @@yr @@mq Mr Atq letz ngr @@de .
X nzrpilzmlr kx nzkuking nc .	x nz @@r @@pi @@lz @@mq @@lr kx nz @@kuki @@ng nc .
52 . Dztu Ami Aglqtrpqgr Mz Lcsu	52 . dztu ami a @@glq @@tr @@mq @@gr mz lcsu
Mztea nyzdr drtqde Mzdxmingr , yc mrkc Nepwzli .	mztea nyz @@dr drtq @@de Mzdxmingr , yc mr @@kc Nepwzli .
A' da kx mrlzvxitx-ngrde , lrmztangi Profesz Wurm , kc tzwzng mz Mama Ini Lzpli , ngipe letzlvz x trwzpeu .	a' da kx mrlzvxi @@tx @@ngr @@de , lrmztangi profesz Wurm , kc tz @@wz @@ng mz mama Ini Lzpli , ngi @@pe letzlvz x tr @@wz @@pe @@u .
Vomc x ninge kc tqalvztrpex Naim .	vo @@mq @@o x ninge kc tq @@alvztr @@pe @@x Naim .
Nzrtwztimqng dalr trmctu nyzdr kx na-aelwatibz mz Kxetu Filip .	nz @@rtwz @@ti @@mq @@ng dalr trmctu nyz @@dr kx na @@aelwa @@ti @@bz mz kx @@etu Filip .
Bokapwr mztea kxtopwzne nyz mzlweng x kxbqng lxegr x ycpx prla .	Bokapwr mztea kx @@topwz @@ne nyz mzlwe @@ngq x kxbq @@ngq lxe @@gr x yc @@px prla .
Kx mcle kc be tabao kcng , vz x sc tqobqtrpe mz rum kc tqtupx-ngrm mqngr Ncbr .	kx mc @@le kc be tabao kcng , vz x sc tq @@obq @@tr @@pe mz rum kc tq @@tu @@px @@ngr @@mq mqngr ncbr .
Nzngrlrpx-krmgr kc ma kc , mqngr drka' kcng dwaplr-ngrtipekr x nznur noli mqgr dwasxpx-kzpqgr ma kc .	nz @@ngrlr @@px @@kr @@mq @@gr kc ma kc , mqngr drka' kcng dwa @@*plx @@ngr @@ti @@pe @@kr x nz @@nu @@r noli mq @@gr dwa @@sx @@px @@kz @@mq @@gr ma kc .
Rpibo bade kx , “ Nigr mz Lrlvz .”	r @@pi @@bo bade kx , “ nigr mz Lrlvz .”
82 . Natq Kx Rmnr-ngrbz	82 . natq kx rmnr @@ngr @@bz
12 . Nounenq Kxetu	12 . nounenq kx @@etu
Kx nzxlrbz kztedeng nzne-krde , sc nznepeng amrlx ngrdr .	kx nz @@xlr @@bz kzte @@de @@ngq nz @@ne @@kr @@de , sc nz @@ne @@pe @@ng amrlx ngr @@dr .
Mz nzsiklu-krnge lc Pawa krlzbo klas rlimz , a' trpaswxu .	mz nz @@siklu @@kr @@nge lc Pawa krlz @@bo klas rlimz , a' tr @@pas @@x @@u .
"Kzdq nimu navz murde ma tqlawititxne nimu amrlx !"""	"kzdq nimu na @@vz @@Ø murde ma tq @@lawi @@ti @@tx @@ne nimu amrlx !"""
Trtenge Melomate yrlztile kzdq olvz lr Trmctu Nemya' mrkc Nea , drtqde Ilrmztangi .	trte @@nge Melomate yrlz @@ti @@le kzdq olvz lr trmctu Nemya' mr @@kc Nea , drtq @@de Ilrmztangi .
68 . Nzmncngr Nepa'	68 . nz @@mnc @@ngr Nepa'
Krlc merikol krapwx .	krlc merikol kra @@pwx .
Kx dwalzmgr mz gq ngr lue kcng , sc tqxngi-atebzkr drtqgr nzbao-krde , mzli kcpe mz rngalx .	kx dwa @@lz @@mq @@gr mz gq ngr lue kcng , sc tq @@xngi @@ate @@bz @@kr drtq @@gr nz @@bao @@kr @@de , mzli kc @@pe mz rngalx .
Skul yctitxpwzle Naim yiz li x ncte kc , x sc tzglqtrpem mou Nabzn .	skul yc @@ti @@tx @@pwz @@le Naim yiz li x nctq @@de kc , x sc tz @@glq @@tr @@pe @@mq mou Nabzn .
X kratq drtqde Polykap Mepapna mzte nzmc mz 7 Aogzs 1967 .	x kra @@tq drtq @@de Polykap Mepapna mz @@te nz @@mc mz 7 Aogzs 1967 .
"Sc tqrpibo kx , "" Eke !"""	"sc tq @@r @@pi @@bo kx , "" eke !"""
Letz krali lc nzyrm mz skul kc Tzngarare .	letz kra @@li lc nz @@yr @@mq mz skul kc Tzngarare .
Nzvz-krdr kc nzyangrngatx-zlwzpe-ngrdr zbrlxkz .	nz @@vz @@kr @@dr kc nz @@yangrnga @@tx @@zlwz @@pe @@ngr @@dr zbrlxkz .
"Kx nzpibzlrle mz Mama Lesile , sc tqrpipebzle kx , "" Trngiu nc nzlu ela , krla Jiszs rkam mqgu lue , mrbrlzm murde sc tqvzpe-mouku badr ."""	"kx nz @@pi @@bz @@lr @@le mz mama Lesile , sc tq @@r @@pi @@pe @@bz @@le kx , "" tr @@ngi @@u nc nzlu e @@la , krla Jiszs r @@ka @@mq mq @@gu lue , mrbr @@lz @@mq murde sc tq @@vz @@pe @@mou @@ku badr ."""
X nzwzngr lc rblx kz murde nawz-angidrkr mz nzrtekqtrngr natq Gct .	x nz @@wz @@ngr lc rblx kz murde na @@wz @@angidr @@kr mz nz @@r @@tekqtr @@ngr natq Gct .
Kx yrkrpxbo kc mz Sosaeti , doa lr Nepa' x Pa'lz sc tzmcpxpelr ninge kx nanginibo kxaonrwx mz mztea lcng li .	kx yrkrpx @@bo kc mz Sosaeti , doa lr Nepa' x Pa'lz sc tz @@mcpx @@pe @@lr ninge kx na @@ngini @@bo kx @@a @@o @@nrwx mz mztea lcng li .
"Zbz kzdq dxbu kxetu kx vzobzle mz nabz bot kc netxpxpnzx mz nzrpi-krnge kx , "" Jiszs okatrpq nigr ."""	"zbz kzdq dxbu kx @@etu kx vz @@o @@bz @@le mz nabz bot kc ne @@tx @@px @@pnz @@x mz nz @@r @@pi @@kr @@nge kx , "" Jiszs okatr @@mq nigr ."""
Murde mz zbq lc tewa dc kz .	murde mz zbq lc tewa dc kz .
Mz yiz lc 1938 , Kxetu ngr Pawa skul sc tqvo mz nzama-krde .	mz yiz lc 1938 , kx @@etu ngr Pawa skul sc tq @@vo @@Ø mz nz @@ama @@kr @@de .
Trngiu nc , krlcng kio ne skul x pnatibzkr , a' trsuka mepyr ngrde kc tqvobe .”	tr @@ngi @@Ø @@u nc , krlcng kio ne skul x pna @@ti @@bz @@kr , a' tr @@su @@ka mepyr ngr @@de kc tq @@vo @@be .”
Lcsukxlvc lcdeng tqngcneom rlwxkr , nzesz'mzng .	lcsu @@kx @@lvc lcdeng tq @@ngc @@ne @@o @@mq rlwx @@kr , nz @@esz'mz @@ng .
Nzycmne-krgr lc x nzrpilzngr nigr waipnz'le mzli kc tqtopwzbe-ngrne , a' kx aoti drtwrngele mzli ka tqryrnge , awitx-ngrbo mz Gct .	nz @@ycmne @@kr @@gr lc x nz @@r @@pilz @@ngr nigr wai @@pnz @@le mzli kc tq @@topwz @@be @@ngr @@ne , a' kx ao @@ti drtwr @@nge @@le mzli ka tq @@r @@yr @@ngr @@ne , awi @@tx @@ngr @@bo mz Gct .
Vzbzkr banyapu lcdeng plctitx-lxblrpe .	vz @@bz @@kr banyapu lcdeng plc @@ti @@tx @@lxblr @@pe .
Zbz mz nibrde kx nzangiolr kc drka' kzbleng , sc tqamrbrtrpele nzangio-krdr Be ncdr Ncbr , nivz lrdr kc mrlzvxi baone kz mz nabzdr .	zbz mz nibr @@de kx nz @@angio @@lr kc drka' kzble @@ngq , sc tq @@a @@mrbr @@tr @@pe @@le nz @@angio @@kr @@dr Be ncdr ncbr , nivz lr @@dr kc mrlzvxi bao @@ne kz mz nabz @@dr .
Yrkrpxbz nzkrka'-krde sc tqrpipebzle kx , “ Sa naoklatitr-mopqgr nim mz nzyzlu-krmgr Bwapc .”	yrkr @@px @@bz @@Ø nz @@krka' @@kr @@de sc tq @@r @@pi @@pe @@bz @@le kx , “ sa na @@okla @@ti @@tr @@mou @@mq @@gr nim mz nz @@yzlu @@kr @@mq @@gr Bwapc .”
X mz nar newz lcde tuom elr ma kx tutipx-ngrm mqngr drka' kxkqlu kx nzangiolr lr Mzdxmingr .	x mz nar newz lcde tu @@o @@mq elr ma kx tu @@ti @@px @@ngr @@mq @@Ø mqngr drka' kx @@kqlu kx nz @@angio @@lr lr Mzdxmingr .
Mz nzyzlu-krgr da kx xpetixng mz maket trmalewxu nzmalebzlr olvi , x nigr badr obla vz-nrbalqnekr .	mz nz @@yzlu @@kr @@gr da kx xpe @@ti @@x @@ng mz maket tr @@male @@x @@u nz @@male @@bz @@lr olvi , x nigr badr obla vz @@nrbalq @@ne @@kr .
Nzlu kcng trkqopqleu , a' bxtrtxpwz mqde nrla esz' mz trpulu rde x sc tqbxplcopem , waile mz trpulu r nzlu kcng amrlx .	nzlu kcng tr @@kq @@o @@mq @@le @@u , a' bx @@tr @@tx @@pwz mq @@de nrla esz' mz trpulu r @@de x sc tq @@bx @@plc @@o @@pe @@mq , wai @@le mz trpulu r nzlu kcng amrlx .
"X rpi-moupqle bange kx , "" A' ninge traolvzu drtwrnge nzwz-krm mrka ."	"x rpi @@mou @@mq @@le bange kx , "" a' ninge traolvzu drtwr @@nge nz @@wz @@kr @@mq mrka ."
26 . Da Kx Mclxng Mz Nzvz-nqblq-krnge Tzsiu	26 . da kx mc @@x @@ngq mz nz @@vz @@nqblq @@kr @@nge tzsiu
Zbz Menabz ncdr trtenge sc tzycmnetrpe-ngrdr nzrlasz-krgr mztea Mzdxmingr .	zbz Menabz ncdr trte @@nge sc tz @@ycmne @@tr @@pe @@ngr @@dr nz @@rlasz @@kr @@gr mztea Mzdxmingr .
53 . Bisop Badle Rpile Navobzkr Malaita	53 . bisop Badle r @@pi @@le na @@vo @@bz @@kr Malaita
"X rpio-mopwzle kx , "" Nabo du ma nc la ."""	"x r @@pi @@o @@mou @@bz @@le kx , "" na @@bo du ma nc la ."""
Kx mcpzkr nzatrkati-krbzlr stoa nyzgr , kzdung nigr sc tzrtwztipe-kzng dalr stoa mz nrlckxbq lcde .	kx mc @@bz @@kr nz @@a @@trka @@ti @@kr @@bz @@lr stoa nyz @@gr , kzdung nigr sc tz @@r @@twz @@ti @@pe @@kz @@ng dalr stoa mz nrlckxbq lcde .
Mzli lcde tqwrkxtr-ngrgr aclvele ninge Tzsiu Jon Binii dalr Vanuatu .	mzli lcde tq @@wrkxtr @@ngr @@gr aclve @@le ninge tzsiu Jon Binii dalr Vanuatu .
A' glrtipeng murde ayzprtilz-pnz-kaix dzbrdr .	a' glr @@ti @@pe @@ngq murde ayzpr @@ti @@lz @@pnz @@kai @@x dzbr @@dr .
"Rpibzle badr kx , "" A , lika ne Metalo ."	"r @@pi @@bz @@le badr kx , "" a , lika ne Metalo ."
Zyagox ngr drtqde kx etunepx-zvzle kc , drtwr leplz amrlx sc tqlitrpebz bade kx trpengr nzmrlzkr Mzdealwx .	zyagox ngr drtq @@de kx etu @@ne @@px @@zvz @@le kc , drtwr leplz amrlx sc tq @@li @@tr @@pe @@bz bade kx trpengr nz @@mrlz @@kr Mzdealwx .
Kratq ninge Saemon Grin Meabr , mzke' nzmc Mzdxmingr mz yiz 1921 .	kra @@tq ninge Saemon Grin Meabr , mz @@ke' nz @@mc Mzdxmingr mz yiz 1921 .
Kx Yr Saemon Grin Meabr	kx yr Saemon Grin Meabr
Kx kqomle kc nigr kc tqvzpemgr .	kx kq @@o @@mq @@le kc nigr kc tq @@vz @@pe @@mq @@gr .
X rpibz Rik kx mrlz a' natwzle pepz scdeng amrlx murde nzwz-krde nawzpe-ngrde mz ma nyzde .	x r @@pi @@bz Rik kx mrlz a' na @@twz @@le pepz sc @@de @@ngq amrlx murde nz @@wz @@kr @@de na @@wz @@pe @@ngr @@de mz ma nyz @@de .
Kx nzxlrmlr nzrpi-krbo nzvz-krbo mz Dckta Fox sc tzvopeng .	kx nz @@xlr @@mq @@lr nz @@r @@pi @@kr @@bo nz @@vz @@kr @@bo mz dckta Fox sc tz @@vo @@pe @@ngq .
Rpimle na-aenzli-kaikr nakqtxom kxpipz .	r @@pi @@mq @@le na @@aenzli @@kai @@kr na @@kq @@tx @@o @@mq kxpipz .
Testimcne lcng trtxpnzngr nzmrbrtr-krdr mz drtwrnge , murde mc-angidrxng mz mzke' x rlapx-ngrneng .	testimcne lcng trtxpnzngr nz @@mrbr @@tr @@kr @@dr mz drtwr @@nge , murde mc @@angidr @@x @@ngq mz mz @@ke' x rlapx @@ngr @@ne @@ngq .
69 . Merikol Tq	69 . merikol tq
Sc tqope kc nidr kxkz kc Neboi .	sc tq @@o @@pe kc nidr kxkz kc Neboi .
Mz narlue sc trtenge lcng , narlue kx twztxpo nzrpzngr nelc x nzryrtingr drlz .	mz narlue sc trte @@nge lcng , narlue kx twz @@tx @@bo nz @@r @@pz @@ngr nelc x nz @@r @@yr @@ti @@ngr drlz .
29 . Vex Dckta Foks Mz Nzamukxtr-krde Pawa Skul	29 . ve @@x Dckta Foks mz nz @@a @@mu @@kx @@tr @@kr @@de Pawa skul
Zbz kx nzxlr kcmiti ngr Sosaeti nzrmusrti-krbo lc trau sc leplz kxkqlu , sc tzyrlwr-lxblrpeng kx naprtxpxpex .	zbz kx nz @@xlr kcmiti ngr Sosaeti nz @@r @@musr @@ti @@kr @@bo lc trau sc leplz kx @@kqlu , sc tz @@yrlwr @@lxblr @@pe @@ng kx na @@pr @@tx @@px @@pe @@x .
Nztwzlr sc tzkukirpelr mz nqlvi r lue kc tqycngr Alankaula skul .	nz @@twz @@lr sc tz @@kuki @@r @@pe @@lr mz nqlvi r lue kc tq @@yc @@ngr Alankaula skul .
Nrlc kqlu kx vztrngr dxvo lc .	nrlc kqlu kx vztr @@ngr dxvo lc .
X mz nzrmc-krbz ncblo ngr bzo kcng li trau kcng x nzvecngr kc tqamaope , x tzodutr-lxblr-moung .	x mz nz @@r @@mc @@kr @@bz ncblo ngr bzo kcng li trau kcng x nzvecngr kc tq @@ama @@o @@pe @@Ø , x tz @@odu @@tr @@lxblr @@mou @@ngq .
47 . Nzobq-kapqkr Ncblo Ngr Ami Badr Kzdu Nigr	47 . nz @@obq @@kapq @@kr ncblo ngr ami badr kzdu nigr
Yzlumitx-moux neimr kio kcng tq mz nabxbz x ninge kc tqvzpex ma nyzgr tqmwipex .	yzlu @@mi @@tx @@mou @@x neimr kio kcng tq mz nabxbz x ninge kc tq @@vz @@pe @@x ma nyz @@gr tq @@mwi @@pe @@x .
Krkc kai yzlu x lvc-alzupq kzdq mou dzbede li .	krkc kai yzlu x lvc @@alzu @@mq kzdq mou dzbede li .
Tupxm mz nabz nounc mrlcde nc nzlu kx trboiu esz'mz .	tu @@px @@mq mz nabz nounc mrlcde nc nzlu kx tr @@boi @@u esz'mz .
Murde lr Fiu kx nzyrlzng nzakititrlr nigr mz ma nyzdr , mz nzapusr-krdr nigr doa nedrng .	murde lr Fiu kx nz @@yrlz @@ng nz @@aki @@ti @@tr @@lr nigr mz ma nyz @@dr , mz nz @@apusr @@kr @@dr nigr doa ne @@dr @@ngq .
Dckrlzde Kc Nzpnu	dckrlzde kc nzpnu
Merikol Ayrnrngr	merikol ayrnr
Nzwrde kratq rpibo badr na-aenzlipwzlr ninge , navz-kaipo mz Dckta murde naka-zpwxbzle badr kx nangi nadr .	nzwr @@de kra @@tq r @@pi @@bo badr na @@aenzli @@pwz @@lr ninge , na @@vz @@kai @@bo mz dckta murde na @@ka @@zpwx @@bz @@le badr kx na @@ngi na @@dr .
Tzsiu Jon vzbz mz trtenge , rpibzle kx , “ Suti drtwrnge narlr-ngrme bagr mrlxm Saemon Grin Meabr , naatwzlr-ngrgr nide mz skul .”	tzsiu Jon vz @@bz mz trte @@nge , r @@pi @@bz @@le kx , “ suti drtwr @@nge na @@rlr @@ngr @@me bagr mrlx @@mq Saemon Grin Meabr , na @@atwzlr @@ngr @@gr nide mz skul .”
Vzx x ninge kc tqyzlupemc .	vz @@x x ninge kc tq @@yzlu @@pe @@mq @@x .
Pitxmle bagr mz Daniel nzvz-kai-krgr Pauabu x sc tqvzpe Auki .	pi @@tx @@mq @@le bagr mz Daniel nz @@vz @@kai @@kr @@gr Pauabu x sc tq @@vz @@pe Auki .
Ma lcde nzxpepx-ngrm takes yrvitx-kzle .	ma lcde nz @@xpe @@px @@ngr @@mq takes yrvi @@tx @@kz @@le .
Kxetu kx rkrlz .	kx @@etu kx r @@krlz .
Krapwx olvz drtqde Ituku mzte nzmc Bokapwr mz yiz 1924 .	kra @@pwx olvz drtq @@de Ituku mz @@te nz @@mc Bokapwr mz yiz 1924 .
Sc tqrpipex kx , “ Eke !”	sc tq @@r @@pi @@pe @@x kx , “ eke !”
Gct lc nzrkatx-krde zyagox , kxyagox tr-rmnqu luekxpiz , tr-rmabru be nounc e leu kx nzmabr .	Gct lc nz @@r @@katx @@kr @@de zyagox , kx @@yagox tr @@rmnq @@u luekxpiz , tr @@r @@mabr @@u be nounc e leu kx nz @@mabr .
Kx xlr kzdq lrtzlvz kx mwitr mz bute' lcde nzyrpuo-krmle elr , sc tqnepe .	kx xlr kzdq lrtzlvz kx mwitr mz bute' lcde nz @@yrpu @@o @@kr @@mq @@le elr , sc tq @@ne @@pe .
Be Kxrpalz nrlc nide kxetubz mz Ncbr .	Be kxrpalz nrlc nide kx @@etu @@bz mz ncbr .
Mzli kc tqycmne-ngrgr mz nzvz-krmgr , tropxu mz mzke' kx tewa kxetu kc tqdc , murde trlrprkru rlilrgr mz nzvz-krmgr .	mzli kc tq @@ycmne @@ngr @@gr mz nz @@vz @@kr @@mq @@gr , tr @@opx @@u mz mz @@ke' kx tewa kx @@etu kc tq @@dc , murde tr @@lrpr @@kr @@u r @@li @@r @@gr mz nz @@vz @@kr @@mq @@gr .
Yzutrpnz mz mzli nyz Rik Biukan krlzmle mzli nyz Daniel x Brenda , kzdung mzli opxm kx nzwzkr nzrtekqtrngr Natq Gct matinetr drtwr .	yzu @@tr @@pnz mz mzli nyz Rik Biukan krlz @@mq @@le mzli nyz Daniel x Brenda , kzdung mzli opxm kx nz @@wz @@kr nz @@r @@tekqtr @@ngr natq Gct ma @@ti @@ne @@tr drtwr .
Mz nibr kzdung zbq , nigr badr trtenge rkalzmqgr x vzkr mz mztea nyz blrkqgr Ilztrkalr , drtqde Narnztilolx .	mz nibr kzdung zbq , nigr badr trte @@nge rkalz @@mq @@gr x vz @@kr mz mztea nyz blrkq @@gr Ilztrkalr , drtq @@de Narnztilolx .
Tzsiu nzvzmqng Nea mz temz Jenwzri mz yiz 1935 .	tzsiu nz @@vz @@mq @@ng Nea mz temz Jenwzri mz yiz 1935 .
X yrlqtr-lxblrbzle nigr Mama Frank Bolen Toke mz Sen Tomas mrkc Bznwz .	x yrlq @@tr @@lxblr @@bz @@le nigr mama Frank Bolen Toke mz Sen Tomas mrkc Bznwz .
"Rpibz Kxetu rgr badr kx , "" Lr Japan nzmncpeng mz skul e trgalr ?"""	"r @@pi @@bz kx @@etu r @@gr badr kx , "" lr Japan nz @@mnc @@pe @@ng mz skul e trgalr ?"""
Ninge kc tqawipebo mz Jiszs murde krlc merikol kx alele .	ninge kc tq @@awi @@pe @@bo mz Jiszs murde krlc merikol kx ale @@le .
Nzyrlz-krnge krali trvzpxpwq bange , a' Josip Clq kx rpitrpq kx nayrlz-moux .	nz @@yrlz @@kr @@nge kra @@li tr @@vz @@px @@mq @@u bange , a' Josip Clq kx r @@pi @@tr @@mq kx na @@yrlz @@mou @@x .
X yclz-kzpz mz leplz lcdeng nepi , temz x kzdung vri x yclz-kzpz da kx apule dcbz x tewa kc tqdcpxm elr .	x yc @@lz @@kz @@pz @@Ø mz leplz lcdeng nepi , temz x kzdung vri x yc @@lz @@kz @@pz @@Ø da kx apu @@le dcbz x tewa kc tq @@dc @@px @@mq @@Ø elr .
Rtrngrtitrle bret li mz sef nyzde , x sc tqtwzpebzle .	rtrngr @@ti @@tr @@le bret li mz sef nyz @@de , x sc tq @@twz @@pe @@bz @@le .
Kx ayamemcle , sc tqmeipe .	kx a @@yame @@mq @@x @@le , sc tq @@mei @@pe .
Nzyrlqtrpzlr mrkc tqlxlvrkipx Ncbr .	nz @@yrlq @@tr @@bz @@lr mrkc tq @@lxlvr @@ki @@px ncbr .
Nqmq x drtwr lcdeng tqtrka dekc tzrtctx-ngrdr veamrlz x nzrtrngrti-alzupwzlr veakapq .	nqmq x drtwr lcdeng tq @@trka dekc tz @@rtctx @@ngr @@dr vea @@mrlz x nz @@rtrngr @@ti @@alzu @@pwz @@lr vea @@kapq .
Trpnzngr leu kx na-atutrpz e napilvzti nrkrdrtq , e leu kx naipqpxngr kxyagox .	trpnzngr leu kx na @@a @@tu @@tr @@pz e na @@pilvz @@ti nrkrdrtq , e leu kx na @@ipq @@px @@ngr kx @@yagox .
"Tekatrtxbzle dapu nc tabao kcng li , sc tqrpibzle kx , "" Tewa dc ."	"teka @@tr @@tx @@bz @@le dapu nc tabao kcng li , sc tq @@r @@pi @@bz @@le kx , "" tewa dc ."
Kzdq kxbqgr drtqde Menckzpo , nzya-zvzng prla mz mzlenge kxetu Metrkrbade mz nzrplx-krdr bwa .	kzdq kxbq @@gr drtq @@de Menckzpo , nz @@ya @@zvz @@ng prla mz mzle @@nge kx @@etu Metrkrbade mz nz @@r @@plx @@kr @@dr bwa .
A' mzli ka mwi-lxlrtxpwzmu ena .	a' mzli ka mwi @@lxlr @@tx @@pwz @@amu ena .
Da lcng kzdung drlzdr prki , pc , bo , blq , plc , bx , mibiz , mqbq , blaopu x yaluli .	da lcng kzdung drlz @@dr prki , pc , bo , blq , plc , bx , mibiz , mqbq , blaopu x yaluli .
Drtwrnge elalztxm nzli-krgr mz Stipin Srpi , murde drtwrnge abrtrpo bade mz kzdung nzycmnengr mz Natqgu .	drtwr @@nge elalz @@tx @@mq nz @@li @@kr @@gr mz Stipin Srpi , murde drtwr @@nge a @@br @@tr @@bo bade mz kzdung nzycmnengr mz Natqgu .
X nzrtwz-kzpqng nra nounc kxnzng .	x nz @@r @@twz @@kz @@mq @@ng nra nounc kx @@nz @@ngq .
Krlcdeng Bznwz x Ncole .	kr @@lc @@de @@ngq Bznwz x Ncole .
Nzo-ngaletio-ngrmlr nigr mzli boitx x sc tzlvc-ateng .	nz @@o @@ngale @@ti @@o @@ngr @@mq @@lr nigr mzli boi @@tx x sc tz @@lvc @@ate @@ng .
Mweitange x blrkqnge drtqdr Mwelea x Iwongr .	mweita @@nge x blrkq @@nge drtq @@dr Mwelea x Iwongr .
Zbz kx krlzbzle kc temz kx esz'mz sc tqatwzlrpemle pepz scdeng amrlx mz Rik Biukan , a' trpnzngr da kx esz' kx yrole elr .	zbz kx krlz @@bz @@le kc temz kx esz'mz sc tq @@atwzlr @@pe @@mq @@le pepz sc @@de @@ngq amrlx mz Rik Biukan , a' trpnzngr da kx esz' kx yr @@o @@le elr .
Lcsu lc vo-ngrm dckta mz nzwz-krde mz trmctu amrlx mrka mz Trmctu Provins .	lcsu lc vo @@ngr @@mq @@Ø dckta mz nz @@wz @@kr @@de mz trmctu amrlx mrka mz trmctu provins .
Mztr nzmc mz mzlir yiz kcng 1700 x nzbzng mz mzlir yiz kcng 1800 .	mz @@tr nz @@mc mz mzlir yiz kcng 1700 x nz @@bz @@ng mz mzlir yiz kcng 1800 .
Yzutrx nzalvztrngr mz skul mz yiz 1950 , x yrkrpxx mz yiz 1972 .	yzu @@tr @@x nz @@alvztr @@ngr mz skul mz yiz 1950 , x yrkr @@px @@x mz yiz 1972 .
Kzdung da kcng tqabrtz-zvz-ngrgr nidr seleng : sokz , krikit , sport , dril , boksing x muvi .	kzdung da kcng tq @@abrtz @@zvz @@ngr @@gr nidr seleng : sokz , krikit , sport , dril , boksing x muvi .
Vzbzkr x nigr kc tqtutxpekr .	vz @@bz @@kr x nigr kc tq @@tu @@tx @@pe @@kr .
Vzbzkr mz kzdq mztea kxtopwz drtqde Akanipua , tewa sc tqetunepxpe mou .	vz @@bz @@kr mz kzdq mztea kx @@topwz drtq @@de Akanipua , tewa sc tq @@etu @@ne @@px @@pe mou .
Vzbo sc tqoszpex .	vz @@bo sc tq @@osz @@pe @@x .
X sc tqngrlrpxpekr tqmncnetrpemgr yz mz nrlar ma kc tqmwi-ngrgr .	x sc tq @@ngrlr @@px @@pe @@kr tq @@mnc @@ne @@tr @@pe @@mq @@gr yz mz nrlar ma kc tq @@mwi @@ngr @@gr .
Mz nibrde leplz kc tqelapebz bade mz nzelangr kxkqlu dalr trmctu nyzgu amrlx .	mz nibr @@de leplz kc tq @@ela @@pe @@bz bade mz nzelangr kx @@kqlu dalr trmctu nyz @@gu amrlx .
Zbz sc tqrpipebo kx mrlx la xlrbo nzrpi-krde kx naxpe nide x nakabz bade trau kc tzkabz Kirakira mz temz kxesz' .	zbz sc tq @@r @@pi @@pe @@bo kx mrlx la xlr @@bo nz @@r @@pi @@kr @@de kx na @@xpe nide x na @@ka @@bz bade trau kc tz @@ka @@bz Kirakira mz temz kx @@esz' .
14 . Narnztilolx Namznrpe	14 . Narnztilolx na @@mznr @@pe @@Ø
Nziklatxpwzng doa amrlx mz set kxesz' .	nz @@ikla @@txpwz @@ng doa amrlx mz set kx @@esz' .
Rmikatxkr noli , nutitxkr taplxsrgr nznurde .	r @@mika @@tx @@kr noli , nu @@ti @@tx @@kr taplxsr @@gr nz @@nu @@r @@de .
Vomc Boo Skul nzkatxpe x nzglqtrpem Naim .	vo @@mq @@o Boo skul nz @@katx @@pe x nz @@glq @@tr @@pe @@mq Naim .
Kx aoti drtwrnge olvz lc mzli ka tqryr-ngrne , sc tqdcpxpe kz kzdo Pita kc tqamrlz Jiszs Kzpznizm , drtqde mrlz x sc tqasupebz nadr dakxnzng , mzli lcdepwz .	kx ao @@ti drtwr @@nge olvz lc mzli ka tq @@r @@yr @@ngr @@ne , sc tq @@dcpx @@pe @@Ø kz kzdo Pita kc tq @@amrlz Jiszs Kzpznizm , drtq @@de mrlz x sc tq @@a @@su @@pe @@bz @@Ø na @@dr dakxnzng , mzli lcde @@pwz .
Yrkrpxbz Ncokz sc tzyamipebzlr nigr Nagu .	yrkr @@px @@bz @@Ø Ncokz sc tz @@ya @@mi @@pe @@bz @@lr nigr Nagu .
Nzdwalzm mz nourla sc tzvzpeng .	nz @@dwalzm mz nourla sc tz @@vz @@pe @@ng .
Nc bia lcde plrkqtu mz legou x leuwaga .	nc bia lcde plrkqtu mz legou x leuwaga .
Dckrlzde Kc Esz'	dckrlzde kc esz'
Yrkrpxbz nzycmne-krbzlr , sc tzyrpalelvzpelr nigr .	yrkr @@px @@bz @@Ø nz @@ycmne @@kr @@bz @@lr , sc tz @@yrpale @@lvz @@pe @@lr nigr .
Ayzlubzle letz sc mama , kx eu , nzsuti drtwrdr ninge .	a @@yzlu @@bz @@le letz sc mama , kx eu , nz @@suti drtwr @@dr ninge .
Zbz sc tqrpipem lxede nanginipegr ncdr .	zbz sc tq @@r @@pi @@pe @@mq lxe @@de na @@ngini @@pe @@gr ncdr .
Nzlvc-krmlr mz nzwrde krali , kx nzmcomlr kc trpnzngr nigr kx tulzm mz drtwrdr bzpekr , sc trtzrpna'peu .	nz @@lvc @@kr @@mq @@lr mz nzwr @@de kra @@li , kx nz @@mc @@o @@mq @@lr kc trpnzngr nigr kx tulz @@mq mz drtwr @@dr bz @@pe @@kr , sc tr @@tz @@r @@pna' @@pe @@u .
Kzdq nidr rmale pu x kzdq rmale tokir vea .	kzdq nidr r @@male pu x kzdq r @@male toki @@r vea .
"X kzdu nidr nznemilr kx , "" Lrtzlvz kc mwatipe drka' !"""	"x kzdu nidr nz @@ne @@mi @@lr kx , "" lrtzlvz kc mwa @@ti @@pe drka' !"""
Trkrlzwxu kx ninge la nabztr-kzx elr dakc tqwai Samwel Samwi e trtingr .	tr @@krlz @@x @@u kx ninge la na @@bz @@tr @@kz @@x elr da @@kc tq @@wai Samwel Samwi e trtingr .
Sc tqatatrpele mz mqngr drka' kc amrlx .	sc tq @@ata @@tr @@pe @@le mz mqngr drka' kc amrlx .
Nzvzbzng mz kzdq nrlc kx atulzngr tzsiu Ini Kopuria kros kx nztqlvztrngr Jiszs .	nz @@vz @@bz @@ng mz kzdq nrlc kx a @@tu @@lz @@ngr tzsiu Ini Kopuria kros kx nz @@tqlvz @@tr @@ngr Jiszs .
Mrlz , sc tzka-mopwzlr bade , tqyzlumi-mopwzle mz Metalo .	mrlz , sc tz @@ka @@mou @@bz @@lr bade , tq @@yzlu @@mi @@mou @@bz @@le mz Metalo .
Kx krlzbo kc yiz kx esz'mz o rlimz , kzdq doa kx line-zvzkr ncdr drtqde Lrlvz .	kx krlz @@bo kc yiz kx esz'mz o rlimz , kzdq doa kx li @@ne @@zvz @@kr ncdr drtq @@de Lrlvz .
Da lcng zbq rdr yc-lxblrbz , x nidr kcng tzamrbrtrlr nzmwelr-krgr x nzvzkr drtwrgr mz nqmq ngr skul kcng tqxplr .	da lcng zbq r @@dr yc @@lxblr @@bz , x nidr kcng tz @@a @@mrbr @@tr @@lr nz @@mwelr @@kr @@gr x nz @@vz @@kr drtwr @@gr mz nqmq ngr skul kcng tq @@xplr .
Leplz lcng nzycblqng amrlx , trpnzngr kx pxi kxesz' .	leplz lcng nz @@ycblq @@ng amrlx , trpnzngr kx pxi @@Ø kx @@esz' .
Nzrpibz doa kcng kx , “ Pokiabzkr .	nz @@r @@pi @@bz doa kcng kx , “ pokia @@bz @@kr .
Mzli kc tqmu-ngrgr , rpibz kxetu r pripekt kc badr doa amrlx kx , “ Kzdq kc da mclx mzli kc tzvz-ngrmqng Dckta Foks ncdr Saemon , rtwztx-nrbalqbo badr taol kx na-amingrti-ngrdr drtqdr .	mzli kc tq @@mu @@ngr @@gr , r @@pi @@bz kxetu r pripekt kc badr doa amrlx kx , “ kzdq kc da mc @@x mzli kc tz @@vz @@ngr @@mq @@ng Dckta Foks ncdr Saemon , r @@twz @@tx @@nrbalq @@bo badr taol kx na @@amingr @@ti @@ngr @@dr drtq @@dr .
Lcsu otibzle nigr murde Veranaso Skul nayzutrpe mou .	lcsu oti @@bz @@le nigr murde Veranaaso skul na @@yzutr @@pe mou .
Nigr lcng li trnipgru doa lr Bznwz kc natqdr nayr mz nzrtekqtrngr Nzryrngrkxtr kc mz Inglis .	nigr lcng li tr @@ni @@mq @@gr @@u doa lr Bznwz kc natq @@dr na @@yr mz nz @@r @@tekqtr @@ngr nzryrngrkxtr kc mz Inglis .
Sc tzrpipelr navz-kaing mz nzkrka'ngr x kio nadr nadotxopq mz nyr .	sc tz @@r @@pi @@pe @@lr na @@vz @@kai @@ng mz nzkrka'ngr x kio na @@dr na @@do @@tx @@o @@mq mz nyr .
Dckrlzde Kc Nzpnu-esz'-nrade-nzlvqn	dckrlzde kc nzpnu @@esz' @@nra @@de @@nzlvqn
Bisop Badle atwzlr-ngrmle bagr kc lcsu drtqde Selwin .	bisop Badle atwzlr @@ngr @@mq @@le bagr kc lcsu drtq @@de Selwin .
Dckta wz-ngrmle bagr Nea nou r bea litxtr , murde mztea kqlu kx leplz ngrdr nzyrlwrmqng Nea .	dckta wz @@ngr @@mq @@le bagr Nea nou r bea li @@tx @@tr , murde mztea kqlu kx leplz ngr @@dr nz @@yrlwr @@mq @@ng Nea .
Skul lc nide kc tqngi sekondzre , nzrpibz sinia skul .	skul lc nide kc tq @@ngi sekondzre , nz @@r @@pi @@bz sinia skul .
Nqvi lc trscu drka' .	nqvi lc tr @@sc @@u drka' .
Bq mzli kc milzpq , rpim Dckta bange kx navzmgr rlilrgr .	bq mzli kc milzpq , r @@pi @@mq dckta bange kx na @@vz @@mq @@gr r @@li @@r @@gr .
X nide kxetubz badr mzledeng x Meleu .	x nide kx @@etu @@bz badr mzle @@de @@ngq x Meleu .
X prtrx mz dzbede lc nzmulr na-aglq-kzng dztudr ami .	x prtr @@x mz dzbede lc nz @@mu @@lr na @@a @@glq @@kz @@ng dztu @@dr ami .
E kx nangi natq esz'txu , Bznwz txpwz kx mrlz .	e kx na @@ngi natq esz'txu , Bznwz txpwz kx mrlz .
X mz nzrtekqtr-krnge Nzryrngrkxtr , yiz li tr-rtwzwxu trau elr , yiz 1977 x 1978 .	x mz nz @@r @@tekqtr @@kr @@nge nzryrngrkxtr , yiz li tr @@r @@twz @@x @@u trau elr , yiz 1977 x 1978 .
Pulis kc tqotimle nigr kaputrpq Fiu mz nourla .	pulis kc tq @@oti @@mq @@le nigr kaputrpq Fiu mz nourla .
Nzapresin-ngr doa kx esz' , li , e tq , a' kx krlzbzle kx nzpnu , trnzpresinu .	nz @@a @@presin @@ngr doa kx esz' , li , e tq , a' kx krlz @@bz @@le kx nzpnu , tr @@nz @@presin @@u .
Dcpwe kx dwao-zvzle kc mz nabz bot scgr Mcnika kc tqyrnipe .	dcpwe kx dwa @@o @@zvz @@le kc mz nabz bot sc @@gr Mcnika kc tq @@yrni @@pe @@Ø .
Dakc tqpipe-ngrbole mz nzycmnengr kc tqycom wq .	da @@kc tq @@pi @@pe @@ngr @@bo @@le mz nzycmnengr kc tq @@yc @@o @@mq @@Ø wq .
Menabz badr doa nedeng nzvz-kaing , nzvzkiolr Nea , nzmncng mz kzdq mztea drtqde Bokapwr .	Menabz badr doa ne @@de @@ngq nz @@vz @@kai @@ng , nz @@vz @@ki @@o @@lr Nea , nz @@mnc @@ngq mz kzdq mztea drtq @@de Bokapwr .
Nzrtekangr lrpz nqesa' kc tzpxi-ngrdr mz mzli r nzelangr lc .	nz @@r @@teka @@ngr lrpz nqesa' kc tz @@pxi @@ngr @@dr mz mzli r nzelangr lc .
Trpnzngr kx navz-nqblqle me pnz' drtwrde , murde trpnzngr zbq kx otx nzrbomkr lr Japan Luga .	trpnzngr kx na @@vz @@nqblq @@le me pnz' drtwrde , murde trpnzngr zbq kx otx nz @@r @@bom @@kr lr Japan Luga .
Murde mrgekr mz sokz , krikit x kzdung kz nzmrgengr kzbleng .	murde mrge @@kr mz sokz , krikit x kzdung kz nzmrgengr kzble @@ngq .
Mnctix mz kosi lcde temz tq x kosi kc tqyrkrpxpe .	mnc @@ti @@x mz kosi lcde temz tq x kosi kc tq @@yrkr @@px @@pe .
Zbz mz temz Julae mz yiz 1943 lcsu Selwin sc tqotipebzle nigr mz Daniel .	zbz mz temz Julae mz yiz 1943 lcsu Selwin sc tq @@oti @@pe @@bz @@le nigr mz Daniel .
Ncblo lcde kq lrpz kxprki x lule stol kxyzlo x aglqpz' .	ncblo lcde kq lrpz kx @@prki x lu @@le stol kx @@yzlo x aglqpz' .
Yrkrpxbz nzycmne-krmle bagr x sc tqotipebzle dakxnzng ngr milzpq nagr .	yrkr @@px @@bz @@Ø nz @@ycmne @@kr @@mq @@le bagr x sc tq @@oti @@pe @@bz @@le dakxnzng ngr milzpq na @@gr .
"Kx mcpxm kxetu r pripekt nigr , ngrlrmimle taol li kx naycpq-ngrgr drtqgr , a' rpibz Dckta kx , "" Drtqgr ycpqtipekr mz taol scgr ."""	"kx mc @@px @@mq kx @@etu r pripekt nigr , ngrlr @@mi @@mq @@le taol li kx na @@ycpq @@ngr @@gr drtq @@gr , a' r @@pi @@bz dckta kx , "" drtq @@gr ycpq @@ti @@pe @@kr mz taol sc @@gr ."""
Krlc merikol .	krlc merikol .
Zbz Dckta , Kzpten x kru nedrng sc tzvope mz lons scdr mrkc Bwzng .	zbz dckta , kzpten x kru ne @@dr @@ngq sc tz @@vo @@pe @@ngq mz lons sc @@dr mrkc Bwzng .
Ncblo obqpx prla , x nzmcpx kz elr trmctu Utupua .	ncblo obq @@px @@Ø prla , x nz @@mc @@px kz elr trmctu Utupua .
Drka' negung nzrkatx-krdr zyagox nzmneti , a' krnedr tzsiu lcng nzkatx-krde zyagox trnzmnetiu , da kc tqwaipex .	drka' ne @@gu @@ngq nz @@r @@katx @@kr @@dr zyagox nz @@mne @@ti , a' kr @@ne @@dr tzsiu lcng nz @@katx @@kr @@de zyagox tr @@nz @@mneti @@u , da kc tq @@wai @@pe @@x .
Zbz nzaelwapx-kz-ngrbz nzrlzngr nuzmu , nrz , lzm , trkrlebq , x popz' x kxmu nzrtekangr br .	zbz nz @@aelwa @@px @@kz @@ngr @@bz nz @@r @@lz @@ngr nuzmu , nrz , lzm , trkrlebq , x popz' x kxmu nz @@r @@teka @@ngr br .
Zbz sc tqpipebo mz sezman ngr skul x sc tzwz-ngrpebzlr badr leplz kxkqlu .	zbz sc tq @@pi @@pe @@bo mz sezman ngr skul x sc tz @@wz @@ngr @@pe @@bz @@lr badr leplz kx @@kqlu .
"Na-aoti drtwrm dalc tqpibo ."""	"na @@a @@oti drtwr @@mq da @@lc tq @@pi @@bo ."""
Kx mclx kc mqngr Ncbr sc tqrpipebo bade kx , navzm nadwatrkr ncdr brma murde namckr ncblc kxprki kc tqwxbupx wqq .	kx mc @@x kc mqngr ncbr sc tq @@r @@pi @@pe @@bo bade kx , na @@vz @@mq na @@dwa @@tr @@kr ncdr brma murde na @@mc @@kr ncblo kx @@prki kc tq @@wxbu @@px @@Ø wq .
39 . Nzrlalz-krgr Mz Newz X Nzveckr Lcsu Mz Mzli Kc Savo	39 . nz @@rla @@lz @@kr @@gr mz newz x nz @@vec @@kr lcsu mz mzli kc Savo
Melzmc , ycpqtxpxx mzke' , yrlqtxbo lrpz ngr Sade x ninge kc tqvzpebo ma nyz Dckta Foks .	melz @@mq @@x , ycpq @@tx @@px @@x mz @@ke' , yrlq @@tx @@bo lrpz ngr Sade x ninge kc tq @@vz @@pe @@bo ma nyz Dckta Foks .
X ni-kzpc' kxetu ngr set .	x ni @@kz @@mq @@x kx @@etu ngr set .
X sc tqvzpem , tqvztrpekr badr mz nabz nc nzlu .	x sc tq @@vz @@pe @@mq , tq @@vz @@tr @@pe @@kr badr mz nabz nc nzlu .
Nzwqkr nenq kc bea tqyzprlz-ngrm nqvi lr lika kc vztx-alo trmwi-pnzu mz nrlckxbq .	nz @@wq @@kr nenq kc bea tq @@yzpr @@lz @@ngr @@mq nqvi lr lika kc vz @@tx @@alo tr @@mwi @@pnz @@u mz nrlckxbq .
Mz Novebz 1954 amnqtxtrpo mz Edwin Dxvo nzngini-krde nar kxnzakrlzng x ninge kc tqyzlupe-moux Boo .	mz Novebz 1954 amnq @@tx @@tr @@bo mz Edwin Dxvo nz @@ngini @@kr @@de nar kx @@nz @@a @@krlz @@ng x ninge kc tq @@yzlu @@pe @@mou @@x Boo .
Leplz lcng leplz kx nzmnclzbz prla .	leplz lcng leplz kx nz @@mnc @@lz @@bz prla .
"Rpimle kx , "" Da kc nzwrde tq tqrpwa'-ngrbzme badr doa kcng nzale-krdrle ; nide la tqalepeq ."""	"r @@pi @@mq @@le kx , "" da kc nzwr @@de tq tq @@rpwa' @@ngr @@bz @@me badr doa kcng nz @@ale @@kr @@dr @@le ; nide la tq @@ale @@pe @@q ."""
A' mzli lc tqyzlupe-ngrmgr nenq kc tqwqpe .	a' mzli lc tq @@yzlu @@pe @@ngr @@mq @@gr nenq kc tq @@wq @@pe @@Ø .
Sc tqrpipem pulis bagr kx navz Auki x namwi elr , a' navz-kaikr x na-aenzlimgr Pauabu .	sc tq @@r @@pi @@pe @@mq pulis ba @@gr kx na @@vz @@Ø Auki x na @@mwi elr , a' na @@vz @@kai @@kr x na @@aenzli @@mq @@gr Pauabu .
"A' rpibzle kx , "" Nzrpi-krme kc , narlxtibzme mz drka' nem Gct nakatxbzle zyagox kc tqdwatimle ninge , atutrpele , drtqnge mrlzpe , rnipex loprta x asumipebo dakxnzng lang tqngqnamu rlilrmu ."""	"a' r @@pi @@bz @@le kx , "" nz @@r @@pi @@kr @@me kc , na @@rlxti @@bz @@me mz drka' ne @@mq Gct na @@katx @@bz @@le zyagox kc tq @@dwati @@mq @@le ninge , a @@tutr @@pe @@le , drtq @@nge mrlz @@pe , r @@ni @@pe @@x loprta x a @@su @@mi @@pe @@bo dakxnzng la @@ngq tq @@ngq @@amu r @@li @@r @@mu ."""
Nzwzngr lc , nzwzngr kx mrlzvxi , a' da kxkqlu naprtzlr nigr kxnzaonrwx trmwipekru murde wztxpwzkr mz lozbq .	nz @@wz @@ngr lc , nz @@wz @@ngr kx mrlzvxi , a' da kx @@kqlu na @@prtz @@lr nigr kx @@nz @@a @@o @@nrwx tr @@mwi @@pe @@kr @@u murde wz @@tx @@pwz @@kr mz lozbq .
Sc tqrpipem kxetu kc na-alvctr-lzbqgr mz bute' ngr nabxbz ngr kzu kc .	sc tq @@r @@pi @@pe @@mq kx @@etu kc na @@alvc @@tr @@lzbq @@gr mz bute' ngr nabxbz ngr kzu kc .
Dckrlzde Kc Rlimz	dckrlzde kc rlimz
Temz tq kx wztx-ngrpwzkr mz skul .	temz tq kx wz @@tx @@ngr @@pwz @@kr mz skul .
Nzmcpxlr doa rtqmz kx navzng badr .	nz @@mc @@px @@lr doa rtqmz kx na @@vz @@ng badr .
Rpimle kx , “ Krlzu , na-aenzlitxki ena nzkqo-krm tewa .”	r @@pi @@mq @@le kx , “ krlzu , na @@aenzli @@tx @@ki ena nz @@kq @@o @@kr @@mq tewa .”
Abzo mz nibr nounenq lcde , vz krlzmle mzli ka , trgalr nounenq kxetu kx mclx kx apule krlcde .	abzo mz nibr nounenq lcde , vz krlz @@mq @@le mzli ka , trgalr nounenq kx @@etu kx mc @@x kx apu @@le kr @@lc @@de .
Kx navzpelr mz maket , sc tqpipebz Mista Lore badr nzvz-krgr badr mz maket .	kx na @@vz @@pe @@lr mz maket , sc tq @@pi @@pe @@bz mista Lore badr nz @@vz @@kr @@gr badr mz maket .
Ncblo kcng nzling nzvzng sc tzobq-kapqpxpeng mz skul .	ncblo kcng nz @@li @@ng nz @@vz @@ng sc tz @@obq @@kapq @@px @@pe @@ng mz skul .
Mz zbq lc vz-ngrbzkr bade nzwrde tq , x nzwrde krapwx sc tqrlrpe-ngrmle nzvo-krgr .	mz zbq lc vz @@ngr @@bz @@kr bade nzwr @@de tq , x nzwr @@de kra @@pwx sc tq @@rlr @@pe @@ngr @@mq @@le nz @@vo @@kr @@gr .
Yrlqbzle drlzdrng amrlx .	yrlq @@bz @@le drlz @@dr @@ngq amrlx .
Murde mz yiz kang kqlu trpnzngr ncblo kcng tzetung mz makxtr kx apqtrle e atubxlzle nzwzngr lc .	murde mz yiz kang kqlu trpnzngr ncblo kcng tz @@etu @@ng mz makxtr kx a @@pq @@tr @@le e a @@tu @@bx @@lz @@le nz @@wz @@ngr lc .
Kx mckr kc trpnzngr nigr kx bz x kx nzataki , nigr kc tqawipebzkr mz Gct mz nzarlapx-krde nigr .	kx mc @@kr kc trpnzngr nigr kx bz x kx nz @@ataki , nigr kc tq @@awi @@pe @@bz @@kr mz Gct mz nz @@arlapx @@kr @@de nigr .
"X rpimle kx , "" Sa tqmrlz ."""	"x r @@pi @@mq @@le kx , "" sa tq @@mrlz ."""
"Otiamu x vecomamu ."""	"oti @@amu x vec @@o @@mq @@amu ."""
Zbz mzli kc mz nourla kxkz kc nzotilr sc tqvzpem .	zbz mzli kc mz nourla kxkz kc nz @@oti @@lr sc tq @@vz @@pe @@mq .
Prlzkr mz bot , yapxkr mz lcsu , x nigr kc tqvopekr Veranaso .	pr @@lz @@kr mz bot , ya @@px @@kr mz lcsu , x nigr kc tq @@vo @@pe @@kr Veranaaso .
A' trayzlupleu natqnge .	a' tr @@a @@yzlu @@mq @@le @@u natq @@nge .
Yrkrpxbz nzycmne-krmle bange x sc tqdwapxpe mou yz .	yrkr @@px @@bz @@Ø nz @@ycmne @@kr @@mq @@le bange x sc tq @@dwa @@px @@pe mou yz .
Mzli kcng tqmnctikr mrkc Daniel trvzou prla x trkrlzleu mrkc mz maket .	mzli kcng tq @@mnc @@ti @@kr mrkc Daniel tr @@vz @@o @@u prla x tr @@krlz @@le @@u mrkc mz maket .
Rik nzrka-krmle bagr nzwzngr ataplxsrle nigr Nrpakxmrlz .	Rik nz @@r @@ka @@kr @@mq @@le ba @@gr nz @@wz @@ngr a @@taplxsr @@le nigr Nrpakxmrlz .
Nounc yrkrtxo mz nzkqtuti-krdelr x nzrplameiti-krde .	nounc yrkr @@tx @@o @@Ø mz nz @@kqtu @@ti @@kr @@de @@lr x nz @@r @@plamei @@ti @@kr @@de .
Nigr kc tqalvctr-lzbqpe elr .	nigr kc tq @@alvc @@tr @@lzbq @@pe elr .
Krlc da kx wzngr Gct , x nzkctitxpx-esz'ngr , x rkatrpq bagr nzrlxngitingr x nzabrtr-krbzkr drtwrgr mz Gct .	krlc da kx wz @@ngr Gct , x nz @@kcti @@tx @@px @@esz'ngr , x r @@ka @@tr @@mq bagr nz @@r @@lxngi @@ti @@ngr x nz @@a @@br @@tr @@kr @@bz @@kr drtwr @@gr mz Gct .
Mz zbq ayrnrngr kc tqkaputr-ngrm yiz kxmrna 1939 , doa lr skul kc Pawa nzvong mz Niu Yiz .	mz zbq ayrnr kc tq @@kaputr @@ngr @@m yiz kx @@mrna 1939 , doa lr skul kc Pawa nz @@vo @@ng mz Niu Yiz .
Kzdung da kcng tzaelwati-ngrbz bade nidr seleng .	kzdung da kcng tz @@aelwa @@ti @@ngr @@bz bade nidr seleng .
X kzdq kxbqgr kz drtqde Meamupa , yane-zvzkr ncdr mz nzalvc-krgr lika mz nzmwa-krgr ncboi .	x kzdq kxbq @@gr kz drtq @@de Meamupa , ya @@ne @@zvz @@kr ncdr mz nz @@a @@lvc @@kr @@gr lika mz nz @@mwa @@kr @@gr ncboi .
Mz yiz kcpwz tqyrlz-ngrne 1962 , rpim Mista Sade na-atwzlr-ngrde ninge Baengr , murde nanginibo kxetu r ncblo kcng tzalvztrng mz skul lcde .	mz yiz kcpwz tq @@yrlz @@ngr @@ne 1962 , r @@pi @@mq mista Sade na @@atwzlr @@ngr @@de ninge Baengr , murde na @@ngini @@bo kx @@etu r ncblo kcng tz @@alvztr @@ng mz skul lcde .
Merikol Kratq	merikol kra @@tq
Dalr nzelangr mz nelc , kc tqngi nzelangr kxmyapxbz mrka Sada Krus .	dalr nzelangr mz nelc , kc tq @@ngi nzelangr kx @@myapxbz mrka Sada Krus .
Kcmiti ngr Sosaeti nzmcpxlr ninge mz Jenwzri 1974 kx nangi ninge dq kz stoakipz .	kcmiti ngr Sosaeti nz @@mc @@px @@lr ninge mz Jenwzri 1974 kx na @@ngi ninge dq kz stoakipz .
Kxetu drtqde Mepalu e Metrkrbade , mzte nzmc Mzdxmingr mz yiz 1915 .	kx @@etu drtq @@de Mepalu e Metrkrbade , mz @@te nz @@mc Mzdxmingr mz yiz 1915 .
X wai-kzle nc naq kc esz' , nrpqde sc tqvzpxpe kz .	x wai @@kz @@le nc naq kc esz' , nrpq @@de sc tq @@vz @@px @@pe kz .
"Rpi-mopwz kxetu r ami kx , "" Mc-kzamu dq da mrlc tqvzkipx , mama ?"""	"rpi @@mou @@bz kxetu r ami kx , "" mc @@kz @@amu dq da mrlc tq @@vz @@ki @@px , mama ?"""
Yrkrpxbz x sc tqryapwxpebz badr leplz amrlx .	yrkr @@px @@bz @@Ø x sc tq @@ryapwx @@pe @@bz badr leplz amrlx .
Drka' kcng tzangiolr , kzdu nzvzpxmqng mz da kx nzmwibletilr , x kzdu drka' ngr melrmqdrng , x kzdu da kx nzrmctinedr mz nzvzne-krdr peto x mz nzyane-krdr prla .	drka' kcng tz @@angio @@lr , kzdu nz @@vz @@px @@mq @@ng mz da kx nz @@mwible @@ti @@lr , x kzdu drka' ngr melrmq @@dr @@ngq , x kzdu da kx nz @@rmcti @@ne @@dr mz nz @@vzne @@kr @@dr peto x mz nz @@yane @@kr @@dr prla .
Krlzbzle mzli kc bea x lcsu ngr vea kc tzkaputrpe tzrpnztrpzng x sc nzotrpzng vz vz mzli kx nztungr ncblo ngr vea mepz , x sc tzvecpeng badr lr Japan .	krlz @@bz @@le mzli kc bea x lcsu ngr vea kc tz @@kaputr @@pe tz @@r @@pnz @@tr @@bz @@ng x sc nz @@o @@tr @@bz @@ng vz vz mzli kx nz @@tu @@ngr ncblo ngr vea mepz , x sc tz @@vec @@pe @@ng badr lr Japan .
Mzli kc tqvzdzpe-ngrmgr mrka Pawa , nrlc sikaputxpwz mz bq r tewa .	mzli kc tq @@vz @@dz @@pe @@ngr @@mq @@gr mrka Pawa , nrlc sikapu @@tx @@pwz mz bq r tewa .
71 . Ninge Kxaonrwx Nepa' x Pa'lz	71 . ninge kxaonrwx Nepa' x Pa'lz
Mr Lore suti drtwrde doa nali mz nzngi-krdr haosboe mrkc Paumalepc , navzbzng badr pulis kc .	Mr Lore suti drtwr @@de doa na @@li mz nz @@ngi @@kr @@dr haosboe mrkc Paumalepc , na @@vz @@bz @@ng badr pulis kc .
Dckrlzde Kc Li	dckrlzde kc li
Kx rpwa'-ngrbz kzpten nzprtz-krbzlr , sc tqrpipebzle kx , “ Mrlz ye , vo-kaiamu , nigr la yane-krlzpwzkr .”	kx rpwa' @@ngr @@bz kzpten nz @@prtz @@kr @@bz @@lr , sc tq @@r @@pi @@pe @@bz @@le kx , “ mrlz ye , vo @@kai @@amu , nigr la ya @@ne @@krlz @@pwz @@kr .”
X nzrpibz kxnzmnztrng mz trtegrng kx , “ Doa nemung sa nayagoxng x nabzng , murde da kxtrmrlzu kc tzwaisz-ngrdr mqngr drka' kcng , x nzapx-ngrbz badr doa kxnztopwz x ncblo txne nzdwatr-krdr ma kc .”	x nz @@r @@pi @@bz kx @@nz @@mnztr @@ng mz trte @@gr @@ngq kx , “ doa ne @@mu @@ngq sa na @@yagox @@ng x na @@bz @@ng , murde da kx @@tr @@mrlz @@u kc tz @@wai @@sr @@ngr @@dr mqngr drka' kcng , x nz @@apx @@ngr @@bz ba @@dr doa kx @@nz @@topwz x ncblo txne nz @@dwatr @@kr @@dr ma kc .”
X mzli lcdepwz katitxpx-kzx Jiszs .	x mzli lcde @@pwz kati @@tx @@px @@kz @@x Jiszs .
Mnctix Mzlo Skul mz nzalvztr-krnge yiz nzlvqn x ninge kc tqayrkrpex nzalvztr-krnge mz Disebz 1972 .	mnc @@ti @@x Mzlo Skul mz nz @@alvztr @@krnge yiz nzlvqn x ninge kc tq @@a @@yrkr @@pe @@x nz @@alvztr @@krnge mz Disebz 1972 .
Mz zbq kcng tq , tqaenzliti-ngrgr lcsu , vomikr peto .	mz zbq kcng tq , tq @@aenzli @@ti @@ngr @@gr lcsu , vo @@mi @@kr peto .
X nzabrtzkr doa kxnzsiklung elr myaszpx-kzle nzabrtzkr doa ngr skul lcng pwx .	x nz @@abrtz @@kr doa kx @@nz @@siklu @@ng elr mya @@sz @@px @@kz @@le nz @@abrtz @@kr doa ngr skul lcng pwx .
Mzli kc mz rngalx nigr kc tqdwalzpemgr x tqmupekr , mrlz yrlqbzkr mclrgr x nigr kc tqvzopekr mz lue kxetu kc nqlvi rde tqycongr Skul Veranaso .	mzli kc mz rngalx nigr kc tq @@dwalzm @@pe @@mq @@gr x tq @@mu @@pe @@kr , mrlz yrlq @@bz @@kr mclr @@gr x nigr kc tq @@vz @@o @@pe @@kr mz lue kx @@etu kc nqlvi r @@de tq @@yc @@o @@ngr skul Veranaaso .
Mz nibrde tewa kxetu kc tqvzpem .	mz nibr @@de tewa kx @@etu kc tq @@vz @@pe @@mq .
Merikol Krali	merikol kra @@li
Mrtutx mqde meitx tatxpx , katxlzmle mq mqngr drka' kc tqmeipx .	mrtu @@tx @@zero mq @@de mei @@tx @@zero ta @@tx @@px @@zero , kapx @@tx @@lz @@mq @@le mq mqngr drka' kc tq @@mei @@px @@Ø .
Vox elr mz nzprtr-krnge mz kosi scdr ncblo kxnzalvztrng .	vo @@x elr mz nz @@prtr @@kr @@nge mz kosi sc @@dr ncblo kxnzalvztrng .
Mnctikr badr mzli trboiu x blrkqgr Ilztrkalr kc tqbzpe .	mnc @@ti @@kr badr mzli tr @@boi @@u x blrkq @@gr Ilztrkalr kc tq @@bz @@pe .
Nzrmnqtxng lue , mrlz , x sc tzvzpe mou .	nz @@rmnq @@tx @@ng lue , mrlz , x sc tz @@vz @@pe mou .
"A' trpnzngr da kx nzalelr kxetu da kc tqwai Be Kxrpalz ."""	"a' trpnzngr da kx nz @@ale @@lr kx @@etu da kc tq @@wai Be kxrpalz ."""
Inyx kzdq letzlvz drtqde Basil Menzq .	inyx kzdq letzlvz drtq @@de Basil Menzq .
Mzli kc , nqvi lr ncblo kc tzayoti nzkrlzlr , x ncblo ngr nqvi lcde lapwz nanibq-kapqlr .	mzli kc , nqvi lr ncblo kc tz @@ayo @@ti nz @@krlz @@lr , x ncblo ngr nqvi lcde la @@pwz na @@nibq @@kapq @@lr .
Dckrlzde Kc Pwx	dckrlzde kc pwx
A' rpimle bange kx , “ Krla tqmrtu-ngrde dzbrde mrvrtipe .”	a' r @@pi @@mq @@le bange kx , “ kr @@la tq @@mrtu @@ngr @@de dzbr @@de mrvr @@ti @@pe .”
Mnctix Baengr yiz li x ncte kc .	mnc @@ti @@x Baengr yiz li x nctq @@de kc .
02 . Doa lr Ma Nyz Trtenge Melomate	02 . doa lr ma nyz trte @@nge Melomate
Mz yiz 1977 , vom kc mrka Bznwz lrmztangi drtqde Rik Biukan .	mz yiz 1977 , vo @@mq kc mrka Bznwz lrmztangi drtq @@de Rik Biukan .
Tqobqnene mrkc trpnzngr kx mclx , x tqabcnene trpnzngr kz kx ayzlumle natqnge .	tq @@obq @@ne @@ne mrkc trpnzngr kx mc @@x , x tq @@abc @@ne @@ne trpnzngr kz kx a @@yzlu @@mq @@le natq @@nge .
Abrtztx-ngrne nzwz-krnge mz Sosaeti murde trau kc nzxpengr ninge myaszpxle kc nzkam bange mz skul mz temz kx esz' .	abrtz @@tx @@ngr @@ne nz @@wz @@kr @@nge mz Sosaeti murde trau kc nz @@xpe @@ngr ninge mya @@sz @@px @@le kc nz @@ka @@mq bange mz skul mz temz kx esz' .
Kx trpnzngr kc nc kx mc-moux , sc tqdcpxpe nzkrka'-krgr .	kx trpnzngr kc nc kx mc @@mou @@x , sc tq @@dcpx @@pe @@Ø nz @@krka' @@kr @@gr .
Ncbr mqngrde nzlz , murde kzdung mzli krlzle nzadcpx-lzbq-ngrbz badr leplz apule ncblo , x nzycmne badr .	ncbr mqngr @@de nz @@lz , murde kzdung mzli krlz @@le nz @@a @@dcpx @@lzbq @@ngr @@bz badr leplz apu @@le ncblo , x nz @@ycmne badr .
Kx mclxle , ninge kc tqyrnipe-mopo mz Kxetu .	kx mc @@x @@le , ni @@nge kc tq @@yrni @@pe @@mou @@mq @@x mz kxetu .
Tzycmnem , tzycmnem , trpnzngr nide kc tqrpna'pe-ngrmle .	tz @@ycmne @@mq , tz @@ycmne @@mq , trpnzngr nide kc tq @@rpna' @@pe @@ngr @@mq @@le .
Dckrlzde Kc Nzpnu-esz'-nrade-esz'	dckrlzde kc nzpnu @@esz' @@nra @@de @@esz'
Leplz kcng tzxpetrpq bange da mz stoa , srlrni kcng na-aprpxbo badr trayrkrpxpou , x kzdu nzaprpx-krbo krscdr kqlutx zlwz , myaszpxle trau kcng tztwzmlr tzxpe-ngrdr da .	leplz kcng tz @@xpe @@tr @@mq bange da mz stoa , srlrni kcng na @@aprpx @@bo badr tr @@ayrkrpx @@bo @@u , x kzdu nz @@aprpx @@kr @@bo kr @@sc @@dr kqlu @@tx zlwz , mya @@sz @@px @@le trau kcng tz @@twz @@mq @@lr tz @@xpe @@ngr @@dr da .